1	鈴木	スズキ	139627	1	139627	2.04029
2	佐藤	サトウ	129537	2	269164	3.93315
3	田中	タナカ	66348	3	335512	4.90265
4	小林	コバヤシ	64767	4	400279	5.84906
5	高橋	タカハシ	63487	5	463766	6.77676
6	渡辺	ワタナベ	63298	6	527064	7.7017
7	加藤	カトウ	59463	7	586527	8.5706
8	斉藤	サイトウ	56617	8	643144	9.39791
9	伊藤	イトウ	55753	9	698897	10.2126
10	中村	ナカムラ	54415	10	753312	11.0077
11	山本	ヤマモト	45780	11	799092	11.6767
12	山田	ヤマダ	44496	12	843588	12.3269
13	山口	ヤマグチ	40511	13	884099	12.9189
14	佐々木	ササキ	39695	14	923794	13.4989
15	■橋	タカハシ	38155	15	961949	14.0564
16	石井	イシイ	38119	16	1000068	14.6134
17	井上	イノウエ	37959	17	1038027	15.1681
18	吉田	ヨシダ	32875	18	1070902	15.6485
19	木村	キムラ	32129	19	1103031	16.118
20	松本	マツモト	30420	20	1133451	16.5625
21	清水	シミズ	30281	21	1163732	17.005
22	金子	カネコ	30199	22	1193931	17.4463
23	石川	イシカワ	29491	23	1223422	17.8772
24	阿部	アベ	27890	24	1251312	18.2847
25	青木	アオキ	27489	25	1278801	18.6864
26	池田	イケダ	26011	26	1304812	19.0665
27	遠藤	エンドウ	25870	27	1330682	19.4445
28	森	モリ	25684	28	1356366	19.8198
29	林	ハヤシ	25665	29	1382031	20.1949
30	長谷川	ハセガワ	25168	30	1407199	20.5626
31	小川	オガワ	25065	31	1432264	20.9289
32	山崎	ヤマザキ	21392	32	1453656	21.2415
33	橋本	ハシモト	21180	33	1474836	21.551
34	後藤	ゴトウ	18817	34	1493653	21.8259
35	内田	ウチダ	18800	35	1512453	22.1006
36	中島	ナカジマ	18295	36	1530748	22.368
37	近藤	コンドウ	18216	37	1548964	22.6342
38	小野	オノ	18210	38	1567174	22.9003
39	和田	ワダ	17825	39	1584999	23.1607
40	山下	ヤマシタ	17599	40	1602598	23.4179
41	原	ハラ	17259	41	1619857	23.6701
42	藤田	フジタ	17246	42	1637103	23.9221
43	杉山	スギヤマ	17030	43	1654133	24.1709
44	三浦	ミウラ	16999	44	1671132	24.4193
45	小島	コジマ	16463	45	1687595	24.6599
46	太田	オオタ	16409	46	1704004	24.8997
47	岡田	オカダ	15914	47	1719918	25.1322
48	中山	ナカヤマ	15763	48	1735681	25.3626
49	前田	マエダ	15693	49	1751374	25.5919
50	村上	ムラカミ	15427	50	1766801	25.8173
51	安藤	アンドウ	15287	51	1782088	26.0407
52	原田	ハラダ	15161	52	1797249	26.2622
53	横山	ヨコヤマ	15079	53	1812328	26.4826
54	石田	イシダ	14842	54	1827170	26.6994
55	坂本	サカモト	14770	55	1841940	26.9153
56	田村	タムラ	14760	56	1856700	27.1309
57	福田	フクダ	14709	57	1871409	27.3459
58	市川	イチカワ	13836	58	1885245	27.548
59	飯田	イイダ	13764	59	1899009	27.7492
60	竹内	タケウチ	13702	60	1912711	27.9494
61	工藤	クドウ	13326	61	1926037	28.1441
62	小山	コヤマ	13131	62	1939168	28.336
63	岡本	オカモト	13087	63	1952255	28.5272
64	大塚	オオツカ	12982	64	1965237	28.7169
65	中野	ナカノ	12799	65	1978036	28.904
66	今井	イマイ	12775	66	1990811	29.0906
67	千葉	チバ	12754	67	2003565	29.277
68	小泉	コイズミ	12742	68	2016307	29.4632
69	松田	マツダ	12683	69	2028990	29.6485
70	新井	アライ	12559	70	2041549	29.832
71	佐野	サノ	12545	71	2054094	30.0153
72	菊地	キクチ	12487	72	2066581	30.1978
73	藤井	フジイ	12366	73	2078947	30.3785
74	岩崎	イワサキ	12146	74	2091093	30.556
75	中川	ナカガワ	11853	75	2102946	30.7292
76	柴田	シバタ	11816	76	2114762	30.9019
77	西村	ニシムラ	11772	77	2126534	31.0739
78	丸山	マルヤマ	11752	78	2138286	31.2456
79	荒井	アライ	11703	79	2149989	31.4166
80	村田	ムラタ	11672	80	2161661	31.5872
81	森田	モリタ	11664	81	2173325	31.7576
82	酒井	サカイ	11455	82	2184780	31.925
83	関	セキ	11390	83	2196170	32.0914
84	土屋	ツチヤ	11202	84	2207372	32.2551
85	秋山	アキヤマ	11171	85	2218543	32.4184
86	大野	オオノ	11137	86	2229680	32.5811
87	菊池	キクチ	11093	87	2240773	32.7432
88	平野	ヒラノ	11034	88	2251807	32.9044
89	増田	マスダ	10967	89	2262774	33.0647
90	五十嵐	イガラシ	10614	90	2273388	33.2198
91	野口	ノグチ	10541	91	2283929	33.3738
92	北村	キタムラ	10488	92	2294417	33.5271
93	武田	タケダ	10405	93	2304822	33.6791
94	宮崎	ミヤザキ	10394	94	2315216	33.831
95	■田	ヨシダ	10192	95	2325408	33.9799
96	菅原	スガワラ	10175	96	2335583	34.1286
97	小松	コマツ	9868	97	2345451	34.2728
98	桜井	サクライ	9816	98	2355267	34.4162
99	内藤	ナイトウ	9803	99	2365070	34.5595
100	久保田	クボタ	9749	100	2374819	34.7019
101	藤原	フジワラ	9657	101	2384476	34.843
102	星野	ホシノ	9560	102	2394036	34.9827
103	川口	カワグチ	9517	103	2403553	35.1218
104	杉本	スギモト	9496	104	2413049	35.2606
105	上野	ウエノ	9457	105	2422506	35.3987
106	望月	モチヅキ	9402	106	2431908	35.5361
107	田辺	タナベ	9301	107	2441209	35.672
108	栗原	クリハラ	9235	108	2450444	35.807
109	渋谷	シブヤ	9156	109	2459600	35.9408
110	小池	コイケ	8970	110	2468570	36.0719
111	松井	マツイ	8910	111	2477480	36.2021
112	安田	ヤスダ	8890	112	2486370	36.332
113	宮本	ミヤモト	8866	113	2495236	36.4615
114	野村	ノムラ	8749	114	2503985	36.5894
115	大久保	オオクボ	8711	115	2512696	36.7166
116	斎藤	サイトウ	8692	116	2521388	36.8437
117	萩原	ハギワラ	8556	117	2529944	36.9687
118	関口	セキグチ	8550	118	2538494	37.0936
119	伊東	イトウ	8465	119	2546959	37.2173
120	須藤	スドウ	8464	120	2555423	37.341
121	島田	シマダ	8360	121	2563783	37.4632
122	飯島	イイジマ	8325	122	2572108	37.5848
123	上田	ウエダ	8323	123	2580431	37.7064
124	永井	ナガイ	8256	124	2588687	37.8271
125	岩田	イワタ	8192	125	2596879	37.9468
126	福島	フクシマ	8018	126	2604897	38.0639
127	本間	ホンマ	8017	127	2612914	38.1811
128	久保	クボ	7938	128	2620852	38.2971
129	木下	キノシタ	7843	129	2628695	38.4117
130	小沢	オザワ	7814	130	2636509	38.5259
131	本田	ホンダ	7813	131	2644322	38.64
132	田口	タグチ	7794	132	2652116	38.7539
133	古川	フルカワ	7766	133	2659882	38.8674
134	榎本	エノモト	7733	134	2667615	38.9804
135	大谷	オオタニ	7701	135	2675316	39.0929
136	石渡	イシワタ	7671	136	2682987	39.205
137	西山	ニシヤマ	7500	137	2690487	39.3146
138	樋口	ヒグチ	7406	138	2697893	39.4228
139	石原	イシハラ	7318	139	2705211	39.5298
140	早川	ハヤカワ	7309	140	2712520	39.6366
141	熊谷	クマガイ	7146	141	2719666	39.741
142	服部	ハツトリ	7136	142	2726802	39.8453
143	平井	ヒライ	7117	143	2733919	39.9493
144	成田	ナリタ	7096	144	2741015	40.0529
145	馬場	ババ	7070	145	2748085	40.1563
146	松尾	マツオ	7027	146	2755112	40.2589
147	齋藤	サイトウ	7010	147	2762122	40.3614
148	渡部	ワタナベ	6994	148	2769116	40.4636
149	岩本	イワモト	6983	149	2776099	40.5656
150	川島	カワシマ	6971	150	2783070	40.6675
151	平田	ヒラタ	6970	151	2790040	40.7693
152	白井	シライ	6846	152	2796886	40.8694
153	高木	タカギ	6749	153	2803635	40.968
154	小澤	オザワ	6712	154	2810347	41.0661
155	内山	ウチヤマ	6697	155	2817044	41.1639
156	水野	ミズノ	6676	156	2823720	41.2615
157	藤本	フジモト	6629	157	2830349	41.3583
158	八木	ヤギ	6602	158	2836951	41.4548
159	根本	ネモト	6594	159	2843545	41.5512
160	川村	カワムラ	6504	160	2850049	41.6462
161	大橋	オオハシ	6488	161	2856537	41.741
162	佐久間	サクマ	6461	162	2862998	41.8354
163	山内	ヤマウチ	6437	163	2869435	41.9295
164	高野	タカノ	6432	164	2875867	42.0235
165	天野	アマノ	6408	165	2882275	42.1171
166	志村	シムラ	6387	166	2888662	42.2104
167	川崎	カワサキ	6355	167	2895017	42.3033
168	関根	セキネ	6347	168	2901364	42.396
169	河野	コウノ	6346	169	2907710	42.4888
170	武藤	ムトウ	6328	170	2914038	42.5812
171	谷口	タニグチ	6295	171	2920333	42.6732
172	落合	オチアイ	6293	172	2926626	42.7652
173	浅野	アサノ	6282	173	2932908	42.857
174	松下	マツシタ	6268	174	2939176	42.9486
175	宮田	ミヤタ	6216	175	2945392	43.0394
176	川上	カワカミ	6185	176	2951577	43.1298
177	上原	ウエハラ	6118	177	2957695	43.2192
178	横田	ヨコタ	6106	178	2963801	43.3084
179	大森	オオモリ	6099	179	2969900	43.3975
180	瀬戸	セト	6089	180	2975989	43.4865
181	石塚	イシヅカ	6059	181	2982048	43.575
182	山中	ヤマナカ	6047	182	2988095	43.6634
183	若林	ワカバヤシ	6033	183	2994128	43.7515
184	大島	オオシマ	6028	184	3000156	43.8396
185	荒木	アラキ	6019	185	3006175	43.9276
186	広瀬	ヒロセ	5992	186	3012167	44.0151
187	菅野	カンノ	5991	187	3018158	44.1027
188	矢野	ヤノ	5988	188	3024146	44.1902
189	大川	オオカワ	5933	189	3030079	44.2769
190	吉川	ヨシカワ	5907	190	3035986	44.3632
191	飯塚	イイヅカ	5883	191	3041869	44.4492
192	相原	アイハラ	5880	192	3047749	44.5351
193	田代	タシロ	5875	193	3053624	44.6209
194	角田	ツノダ	5863	194	3059487	44.7066
195	小野寺	オノデラ	5795	195	3065282	44.7913
196	岸	キシ	5755	196	3071037	44.8754
197	松岡	マツオカ	5753	197	3076790	44.9594
198	浜田	ハマダ	5750	198	3082540	45.0435
199	金井	カナイ	5727	199	3088267	45.1271
200	篠原	シノハラ	5722	200	3093989	45.2108
201	村山	ムラヤマ	5705	201	3099694	45.2941
202	本多	ホンダ	5677	202	3105371	45.3771
203	長島	ナガシマ	5672	203	3111043	45.46
204	西川	ニシカワ	5645	204	3116688	45.5424
205	松村	マツムラ	5613	205	3122301	45.6245
206	大石	オオイシ	5558	206	3127859	45.7057
207	松浦	マツウラ	5551	207	3133410	45.7868
208	三橋	ミツハシ	5531	208	3138941	45.8676
209	石橋	イシバシ	5501	209	3144442	45.948
210	永田	ナガタ	5452	210	3149894	46.0277
211	野田	ノダ	5436	211	3155330	46.1071
212	吉野	ヨシノ	5416	212	3160746	46.1862
213	柏木	カシワギ	5413	213	3166159	46.2653
214	高田	タカダ	5410	214	3171569	46.3444
215	大木	オオキ	5390	215	3176959	46.4232
216	鎌田	カマタ	5365	216	3182324	46.5016
217	尾崎	オザキ	5349	217	3187673	46.5797
218	大山	オオヤマ	5339	218	3193012	46.6577
219	黒田	クロダ	5323	219	3198335	46.7355
220	堀	ホリ	5311	220	3203646	46.8131
221	平山	ヒラヤマ	5255	221	3208901	46.8899
222	辻	ツジ	5226	222	3214127	46.9663
223	西田	ニシダ	5192	223	3219319	47.0421
224	星	ホシ	5165	224	3224484	47.1176
225	富田	トミタ	5147	225	3229631	47.1928
226	吉村	ヨシムラ	5137	226	3234768	47.2679
227	多田	タダ	5112	227	3239880	47.3426
228	小倉	オグラ	5103	228	3244983	47.4172
229	及川	オイカワ	5101	229	3250084	47.4917
230	牧野	マキノ	5047	230	3255131	47.5654
231	臼井	ウスイ	5004	231	3260135	47.6386
232	稲葉	イナバ	5002	232	3265137	47.7117
233	岡部	オカベ	4989	233	3270126	47.7846
234	■木	タカギ	4958	234	3275084	47.857
235	青山	アオヤマ	4949	235	3280033	47.9293
236	小宮	コミヤ	4879	236	3284912	48.0006
237	松原	マツバラ	4879	236	3289791	48.0719
238	田島	タジマ	4869	238	3294660	48.1431
239	小笠原	オガサワラ	4859	239	3299519	48.2141
240	片山	カタヤマ	4839	240	3304358	48.2848
241	宮下	ミヤシタ	4832	241	3309190	48.3554
242	笠原	カサハラ	4823	242	3314013	48.4259
243	今野	コンノ	4805	243	3318818	48.4961
244	渡邊	ワタナベ	4764	244	3323582	48.5657
245	堀内	ホリウチ	4747	245	3328329	48.635
246	岡村	オカムラ	4741	246	3333070	48.7043
247	米山	ヨネヤマ	4722	247	3337792	48.7733
248	大西	オオニシ	4718	248	3342510	48.8423
249	松永	マツナガ	4718	248	3347228	48.9112
250	大竹	オオタケ	4699	250	3351927	48.9799
251	吉岡	ヨシオカ	4693	251	3356620	49.0484
252	白石	シライシ	4673	252	3361293	49.1167
253	須田	スダ	4651	253	3365944	49.1847
254	今村	イマムラ	4631	254	3370575	49.2524
255	小田	オダ	4499	255	3375074	49.3181
256	岡崎	オカザキ	4447	256	3379521	49.3831
257	畠山	ハタケヤマ	4391	257	3383912	49.4472
258	大貫	オオヌキ	4369	258	3388281	49.5111
259	中西	ナカニシ	4331	259	3392612	49.5744
260	新倉	ニイクラ	4327	260	3396939	49.6376
261	町田	マチダ	4325	261	3401264	49.7008
262	足立	アダチ	4319	262	3405583	49.7639
263	山岸	ヤマギシ	4319	262	3409902	49.827
264	中田	ナカダ	4311	264	3414213	49.89
265	石黒	イシグロ	4265	265	3418478	49.9523
266	大沢	オオサワ	4255	266	3422733	50.0145
267	長田	オサダ	4221	267	3426954	50.0762
268	荒川	アラカワ	4216	268	3431170	50.1378
269	武井	タケイ	4215	269	3435385	50.1994
270	渡部	ワタベ	4211	270	3439596	50.2609
271	三上	ミカミ	4210	271	3443806	50.3224
272	村松	ムラマツ	4206	272	3448012	50.3839
273	奥山	オクヤマ	4199	273	3452211	50.4453
274	坂井	サカイ	4198	274	3456409	50.5066
275	岡	オカ	4197	275	3460606	50.5679
276	根岸	ネギシ	4185	276	3464791	50.6291
277	秋元	アキモト	4182	277	3468973	50.6902
278	宮川	ミヤガワ	4168	278	3473141	50.7511
279	寺田	テラダ	4147	279	3477288	50.8117
280	片岡	カタオカ	4135	280	3481423	50.8721
281	福井	フクイ	4126	281	3485549	50.9324
282	安部	アベ	4112	282	3489661	50.9925
283	児玉	コダマ	4106	283	3493767	51.0525
284	渡邉	ワタナベ	4097	284	3497864	51.1124
285	古谷	フルヤ	4074	285	3501938	51.1719
286	山■	ヤマザキ	3991	286	3505929	51.2302
287	相沢	アイザワ	3983	287	3509912	51.2884
288	神田	カンダ	3961	288	3513873	51.3463
289	杉浦	スギウラ	3931	289	3517804	51.4037
290	黒川	クロカワ	3918	290	3521722	51.461
291	河合	カワイ	3888	291	3525610	51.5178
292	杉田	スギタ	3873	292	3529483	51.5744
293	竹田	タケダ	3866	293	3533349	51.6309
294	中嶋	ナカジマ	3854	294	3537203	51.6872
295	沼田	ヌマタ	3829	295	3541032	51.7432
296	津田	ツダ	3808	296	3544840	51.7988
297	滝沢	タキザワ	3806	297	3548646	51.8544
298	松崎	マツザキ	3798	298	3552444	51.9099
299	青柳	アオヤギ	3795	299	3556239	51.9654
300	矢島	ヤジマ	3794	300	3560033	52.0208
301	庄司	シヨウジ	3780	301	3563813	52.076
302	江口	エグチ	3765	302	3567578	52.1311
303	守屋	モリヤ	3756	303	3571334	52.1859
304	森山	モリヤマ	3739	304	3575073	52.2406
305	荻野	オギノ	3679	305	3578752	52.2943
306	坂田	サカタ	3670	306	3582422	52.348
307	大場	オオバ	3639	307	3586061	52.4011
308	古屋	フルヤ	3632	308	3589693	52.4542
309	■野	タカノ	3615	309	3593308	52.507
310	小西	コニシ	3609	310	3596917	52.5598
311	篠崎	シノザキ	3599	311	3600516	52.6124
312	堀江	ホリエ	3570	312	3604086	52.6645
313	安達	アダチ	3560	313	3607646	52.7165
314	浅井	アサイ	3546	314	3611192	52.7684
315	北川	キタガワ	3545	315	3614737	52.8202
316	古賀	コガ	3537	316	3618274	52.8719
317	中沢	ナカザワ	3537	316	3621811	52.9235
318	森本	モリモト	3537	316	3625348	52.9752
319	栗田	クリタ	3531	319	3628879	53.0268
320	野崎	ノザキ	3521	320	3632400	53.0783
321	土田	ツチダ	3520	321	3635920	53.1297
322	神谷	カミヤ	3515	322	3639435	53.1811
323	三宅	ミヤケ	3497	323	3642932	53.2322
324	平本	ヒラモト	3495	324	3646427	53.2832
325	塚本	ツカモト	3494	325	3649921	53.3343
326	戸田	トダ	3469	326	3653390	53.385
327	■田	タカダ	3461	327	3656851	53.4356
328	稲垣	イナガキ	3448	328	3660299	53.4859
329	高山	タカヤマ	3446	329	3663745	53.5363
330	豊田	トヨダ	3422	330	3667167	53.5863
331	堤	ツツミ	3415	331	3670582	53.6362
332	露木	ツユキ	3408	332	3673990	53.686
333	大澤	オオサワ	3396	333	3677386	53.7356
334	細谷	ホソヤ	3396	333	3680782	53.7852
335	大内	オオウチ	3391	335	3684173	53.8348
336	塚田	ツカダ	3384	336	3687557	53.8842
337	小嶋	コジマ	3375	337	3690932	53.9336
338	大津	オオツ	3374	338	3694306	53.9829
339	澤田	サワダ	3372	339	3697678	54.0321
340	菅野	スガノ	3357	340	3701035	54.0812
341	奥村	オクムラ	3344	341	3704379	54.1301
342	関野	セキノ	3335	342	3707714	54.1788
343	河原	カワハラ	3329	343	3711043	54.2274
344	坂口	サカグチ	3301	344	3714344	54.2757
345	細川	ホソカワ	3277	345	3717621	54.3236
346	泉	イズミ	3272	346	3720893	54.3714
347	南	ミナミ	3267	347	3724160	54.4191
348	森川	モリカワ	3266	348	3727426	54.4668
349	横溝	ヨコミゾ	3266	348	3730692	54.5146
350	大村	オオムラ	3252	350	3733944	54.5621
351	櫻井	サクライ	3199	351	3737143	54.6088
352	亀井	カメイ	3197	352	3740340	54.6555
353	西	ニシ	3175	353	3743515	54.7019
354	二宮	ニノミヤ	3165	354	3746680	54.7482
355	岩井	イワイ	3163	355	3749843	54.7944
356	小菅	コスゲ	3158	356	3753001	54.8405
357	■川	ヨシカワ	3153	357	3756154	54.8866
358	矢部	ヤベ	3149	358	3759303	54.9326
359	水谷	ミズタニ	3140	359	3762443	54.9785
360	吉原	ヨシハラ	3138	360	3765581	55.0244
361	窪田	クボタ	3120	361	3768701	55.07
362	岡野	オカノ	3119	362	3771820	55.1155
363	野中	ノナカ	3119	362	3774939	55.1611
364	谷	タニ	3117	364	3778056	55.2067
365	下田	シモダ	3093	365	3781149	55.2519
366	奥田	オクダ	3076	366	3784225	55.2968
367	中尾	ナカオ	3073	367	3787298	55.3417
368	大矢	オオヤ	3051	368	3790349	55.3863
369	金田	カネダ	3051	368	3793400	55.4309
370	手塚	テヅカ	3042	370	3796442	55.4753
371	河村	カワムラ	3041	371	3799483	55.5198
372	植田	ウエダ	3039	372	3802522	55.5642
373	山川	ヤマカワ	3033	373	3805555	55.6085
374	梅田	ウメダ	3008	374	3808563	55.6524
375	松山	マツヤマ	3003	375	3811566	55.6963
376	村井	ムライ	3000	376	3814566	55.7402
377	中里	ナカザト	2992	377	3817558	55.7839
378	中原	ナカハラ	2990	378	3820548	55.8276
379	柳沢	ヤナギサワ	2987	379	3823535	55.8712
380	中澤	ナカザワ	2986	380	3826521	55.9148
381	中田	ナカタ	2980	381	3829501	55.9584
382	安西	アンザイ	2978	382	3832479	56.0019
383	宮内	ミヤウチ	2969	383	3835448	56.0453
384	井出	イデ	2951	384	3838399	56.0884
385	森下	モリシタ	2950	385	3841349	56.1315
386	金沢	カナザワ	2930	386	3844279	56.1743
387	松野	マツノ	2930	386	3847209	56.2172
388	福本	フクモト	2915	388	3850124	56.2597
389	柳川	ヤナガワ	2910	389	3853034	56.3023
390	沢田	サワダ	2909	390	3855943	56.3448
391	黒沢	クロサワ	2889	391	3858832	56.387
392	細野	ホソノ	2878	392	3861710	56.429
393	相馬	ソウマ	2875	393	3864585	56.4711
394	小室	コムロ	2861	394	3867446	56.5129
395	永野	ナガノ	2839	395	3870285	56.5543
396	河野	カワノ	2775	396	3873060	56.5949
397	東	アズマ	2773	397	3875833	56.6354
398	杉崎	スギザキ	2764	398	3878597	56.6758
399	石山	イシヤマ	2733	399	3881330	56.7157
400	長尾	ナガオ	2702	400	3884032	56.7552
401	曽根	ソネ	2695	401	3886727	56.7946
402	保坂	ホサカ	2692	402	3889419	56.8339
403	川田	カワダ	2691	403	3892110	56.8733
404	新田	ニツタ	2683	404	3894793	56.9125
405	松島	マツシマ	2683	404	3897476	56.9517
406	土井	ドイ	2682	406	3900158	56.9909
407	上村	カミムラ	2675	407	3902833	57.03
408	前川	マエカワ	2667	408	3905500	57.0689
409	桑原	クワハラ	2652	409	3908152	57.1077
410	平川	ヒラカワ	2638	410	3910790	57.1462
411	二見	フタミ	2635	411	3913425	57.1847
412	並木	ナミキ	2632	412	3916057	57.2232
413	西野	ニシノ	2631	413	3918688	57.2616
414	篠田	シノダ	2628	414	3921316	57.3
415	曽我	ソガ	2626	415	3923942	57.3384
416	植木	ウエキ	2624	416	3926566	57.3768
417	川端	カワバタ	2624	416	3929190	57.4151
418	島村	シマムラ	2622	418	3931812	57.4534
419	徳永	トクナガ	2608	419	3934420	57.4915
420	奈良	ナラ	2605	420	3937025	57.5296
421	相澤	アイザワ	2592	421	3939617	57.5675
422	宮原	ミヤハラ	2582	422	3942199	57.6052
423	冨田	トミタ	2580	423	3944779	57.6429
424	三好	ミヨシ	2576	424	3947355	57.6805
425	倉田	クラタ	2564	425	3949919	57.718
426	平林	ヒラバヤシ	2562	426	3952481	57.7554
427	芳賀	ハガ	2560	427	3955041	57.7928
428	菅沼	スガヌマ	2557	428	3957598	57.8302
429	甲斐	カイ	2554	429	3960152	57.8675
430	長岡	ナガオカ	2551	430	3962703	57.9048
431	山村	ヤマムラ	2546	431	3965249	57.942
432	吉沢	ヨシザワ	2544	432	3967793	57.9792
433	朝倉	アサクラ	2535	433	3970328	58.0162
434	高梨	タカナシ	2535	433	3972863	58.0533
435	藤沢	フジサワ	2532	435	3975395	58.0903
436	嶋田	シマダ	2528	436	3977923	58.1272
437	福岡	フクオカ	2523	437	3980446	58.1641
438	中井	ナカイ	2516	438	3982962	58.2008
439	磯部	イソベ	2507	439	3985469	58.2375
440	長野	ナガノ	2470	440	3987939	58.2736
441	柳田	ヤナギダ	2470	440	3990409	58.3097
442	■山	タカヤマ	2467	442	3992876	58.3457
443	相川	アイカワ	2466	443	3995342	58.3817
444	片桐	カタギリ	2464	444	3997806	58.4177
445	井口	イグチ	2455	445	4000261	58.4536
446	岩瀬	イワセ	2452	446	4002713	58.4894
447	宮沢	ミヤザワ	2451	447	4005164	58.5253
448	小原	オバラ	2448	448	4007612	58.561
449	水島	ミズシマ	2447	449	4010059	58.5968
450	北原	キタハラ	2440	450	4012499	58.6324
451	皆川	ミナガワ	2440	450	4014939	58.6681
452	長沢	ナガサワ	2439	452	4017378	58.7037
453	大槻	オオツキ	2431	453	4019809	58.7393
454	藤野	フジノ	2425	454	4022234	58.7747
455	大井	オオイ	2421	455	4024655	58.8101
456	榊原	サカキバラ	2418	456	4027073	58.8454
457	池上	イケガミ	2416	457	4029489	58.8807
458	持田	モチダ	2409	458	4031898	58.9159
459	佐伯	サエキ	2398	459	4034296	58.951
460	廣瀬	ヒロセ	2398	459	4036694	58.986
461	大原	オオハラ	2394	461	4039088	59.021
462	三木	ミキ	2393	462	4041481	59.0559
463	宇野	ウノ	2378	463	4043859	59.0907
464	大沼	オオヌマ	2375	464	4046234	59.1254
465	西尾	ニシオ	2367	465	4048601	59.16
466	岸本	キシモト	2362	466	4050963	59.1945
467	早坂	ハヤサカ	2360	467	4053323	59.229
468	茂木	モギ	2358	468	4055681	59.2634
469	植松	ウエマツ	2346	469	4058027	59.2977
470	堀口	ホリグチ	2345	470	4060372	59.332
471	黒木	クロキ	2340	471	4062712	59.3662
472	内海	ウツミ	2330	472	4065042	59.4002
473	熊沢	クマザワ	2328	473	4067370	59.4342
474	広田	ヒロタ	2326	474	4069696	59.4682
475	大友	オオトモ	2323	475	4072019	59.5022
476	小出	コイデ	2322	476	4074341	59.5361
477	桑原	クワバラ	2318	477	4076659	59.57
478	出口	デグチ	2306	478	4078965	59.6037
479	山根	ヤマネ	2304	479	4081269	59.6373
480	北島	キタジマ	2294	480	4083563	59.6709
481	下山	シモヤマ	2293	481	4085856	59.7044
482	雨宮	アメミヤ	2285	482	4088141	59.7378
483	進藤	シンドウ	2284	483	4090425	59.7711
484	小俣	オマタ	2279	484	4092704	59.8044
485	笠井	カサイ	2276	485	4094980	59.8377
486	宇佐美	ウサミ	2267	486	4097247	59.8708
487	竹村	タケムラ	2266	487	4099513	59.9039
488	秋本	アキモト	2259	488	4101772	59.9369
489	重田	シゲタ	2258	489	4104030	59.9699
490	浅田	アサダ	2251	490	4106281	60.0028
491	川原	カワハラ	2248	491	4108529	60.0357
492	磯崎	イソザキ	2233	492	4110762	60.0683
493	石崎	イシザキ	2223	493	4112985	60.1008
494	片野	カタノ	2217	494	4115202	60.1332
495	諸星	モロホシ	2215	495	4117417	60.1656
496	古田	フルタ	2207	496	4119624	60.1978
497	森谷	モリヤ	2207	496	4121831	60.2301
498	志賀	シガ	2198	498	4124029	60.2622
499	富永	トミナガ	2197	499	4126226	60.2943
500	野沢	ノザワ	2195	500	4128421	60.3263
501	長瀬	ナガセ	2191	501	4130612	60.3584
502	神保	ジンボ	2184	502	4132796	60.3903
503	鶴田	ツルタ	2174	503	4134970	60.422
504	福原	フクハラ	2171	504	4137141	60.4538
505	小坂	コサカ	2170	505	4139311	60.4855
506	藤村	フジムラ	2159	506	4141470	60.517
507	川瀬	カワセ	2146	507	4143616	60.5484
508	川井	カワイ	2144	508	4145760	60.5797
509	栗山	クリヤマ	2144	508	4147904	60.611
510	島崎	シマザキ	2141	510	4150045	60.6423
511	大平	オオヒラ	2137	511	4152182	60.6736
512	三井	ミツイ	2130	512	4154312	60.7047
513	梅沢	ウメザワ	2127	513	4156439	60.7358
514	下村	シモムラ	2125	514	4158564	60.7668
515	内野	ウチノ	2117	515	4160681	60.7977
516	浅見	アサミ	2116	516	4162797	60.8287
517	飯野	イイノ	2110	517	4164907	60.8595
518	大城	オオシロ	2110	517	4167017	60.8903
519	志田	シダ	2109	519	4169126	60.9211
520	小森	コモリ	2105	520	4171231	60.9519
521	菅原	スガハラ	2103	521	4173334	60.9826
522	今泉	イマイズミ	2101	522	4175435	61.0133
523	岩渕	イワブチ	2100	523	4177535	61.044
524	溝口	ミゾグチ	2091	524	4179626	61.0746
525	市村	イチムラ	2089	525	4181715	61.1051
526	板垣	イタガキ	2083	526	4183798	61.1355
527	西岡	ニシオカ	2080	527	4185878	61.1659
528	小杉	コスギ	2078	528	4187956	61.1963
529	堀川	ホリカワ	2073	529	4190029	61.2266
530	三田	ミタ	2062	530	4192091	61.2567
531	勝又	カツマタ	2059	531	4194150	61.2868
532	田畑	タバタ	2052	532	4196202	61.3168
533	堀田	ホツタ	2046	533	4198248	61.3467
534	岩沢	イワサワ	2035	534	4200283	61.3764
535	東	ヒガシ	2032	535	4202315	61.4061
536	竹下	タケシタ	2031	536	4204346	61.4358
537	宮城	ミヤギ	2028	537	4206374	61.4654
538	依田	ヨダ	2018	538	4208392	61.4949
539	坪井	ツボイ	2005	539	4210397	61.5242
540	三輪	ミワ	1999	540	4212396	61.5534
541	田原	タハラ	1998	541	4214394	61.5826
542	永島	ナガシマ	1998	541	4216392	61.6118
543	草野	クサノ	1997	543	4218389	61.641
544	米田	ヨネダ	1995	544	4220384	61.6702
545	神山	カミヤマ	1994	545	4222378	61.6993
546	浜野	ハマノ	1994	545	4224372	61.7284
547	川野	カワノ	1990	547	4226362	61.7575
548	宮川	ミヤカワ	1987	548	4228349	61.7865
549	三村	ミムラ	1984	549	4230333	61.8155
550	田所	タドコロ	1981	550	4232314	61.8445
551	府川	フカワ	1980	551	4234294	61.8734
552	吉澤	ヨシザワ	1974	552	4236268	61.9023
553	入江	イリエ	1962	553	4238230	61.9309
554	花田	ハナダ	1958	554	4240188	61.9595
555	川本	カワモト	1956	555	4242144	61.9881
556	長澤	ナガサワ	1953	556	4244097	62.0167
557	木内	キウチ	1941	557	4246038	62.045
558	金澤	カナザワ	1939	558	4247977	62.0734
559	濱田	ハマダ	1935	559	4249912	62.1016
560	黒澤	クロサワ	1930	560	4251842	62.1298
561	緒方	オガタ	1926	561	4253768	62.158
562	葛西	カサイ	1926	561	4255694	62.1861
563	奥津	オクツ	1921	563	4257615	62.2142
564	竹中	タケナカ	1919	564	4259534	62.2422
565	齊藤	サイトウ	1912	565	4261446	62.2702
566	藤川	フジカワ	1912	565	4263358	62.2981
567	小柳	コヤナギ	1910	567	4265268	62.326
568	亀山	カメヤマ	1907	568	4267175	62.3539
569	宮澤	ミヤザワ	1906	569	4269081	62.3817
570	諏訪	スワ	1903	570	4270984	62.4095
571	風間	カザマ	1901	571	4272885	62.4373
572	筒井	ツツイ	1899	572	4274784	62.4651
573	比嘉	ヒガ	1895	573	4276679	62.4928
574	柳	ヤナギ	1895	573	4278574	62.5205
575	布施	フセ	1890	575	4280464	62.5481
576	麻生	アソウ	1884	576	4282348	62.5756
577	尾形	オガタ	1883	577	4284231	62.6031
578	湯浅	ユアサ	1874	578	4286105	62.6305
579	園田	ソノダ	1870	579	4287975	62.6578
580	李	リ	1870	579	4289845	62.6851
581	半田	ハンダ	1869	581	4291714	62.7125
582	横井	ヨコイ	1867	582	4293581	62.7397
583	藤岡	フジオカ	1862	583	4295443	62.7669
584	白川	シラカワ	1855	584	4297298	62.7941
585	杉原	スギハラ	1853	585	4299151	62.8211
586	松沢	マツザワ	1852	586	4301003	62.8482
587	矢口	ヤグチ	1851	587	4302854	62.8752
588	安斉	アンザイ	1850	588	4304704	62.9023
589	松木	マツキ	1844	589	4306548	62.9292
590	菅谷	スガヤ	1843	590	4308391	62.9562
591	石垣	イシガキ	1840	591	4310231	62.983
592	座間	ザマ	1832	592	4312063	63.0098
593	若松	ワカマツ	1832	592	4313895	63.0366
594	岩■	イワサキ	1830	594	4315725	63.0633
595	向井	ムカイ	1825	595	4317550	63.09
596	富樫	トガシ	1824	596	4319374	63.1166
597	井田	イダ	1821	597	4321195	63.1432
598	湯川	ユカワ	1820	598	4323015	63.1698
599	秋葉	アキバ	1818	599	4324833	63.1964
600	野本	ノモト	1814	600	4326647	63.2229
601	安井	ヤスイ	1811	601	4328458	63.2494
602	長井	ナガイ	1810	602	4330268	63.2758
603	畑	ハタ	1806	603	4332074	63.3022
604	有馬	アリマ	1803	604	4333877	63.3286
605	福山	フクヤマ	1802	605	4335679	63.3549
606	椎野	シイノ	1800	606	4337479	63.3812
607	三枝	サエグサ	1797	607	4339276	63.4075
608	大和田	オオワダ	1793	608	4341069	63.4337
609	阿久津	アクツ	1790	609	4342859	63.4598
610	長嶋	ナガシマ	1790	609	4344649	63.486
611	梶原	カジワラ	1789	611	4346438	63.5121
612	江藤	エトウ	1784	612	4348222	63.5382
613	宍戸	シシド	1784	612	4350006	63.5642
614	廣田	ヒロタ	1784	612	4351790	63.5903
615	竹本	タケモト	1781	615	4353571	63.6163
616	難波	ナンバ	1779	616	4355350	63.6423
617	亀田	カメダ	1776	617	4357126	63.6683
618	遠山	トオヤマ	1774	618	4358900	63.6942
619	清野	セイノ	1771	619	4360671	63.7201
620	高瀬	タカセ	1771	619	4362442	63.746
621	細田	ホソダ	1771	619	4364213	63.7718
622	丹羽	ニワ	1767	622	4365980	63.7977
623	小谷	コタニ	1766	623	4367746	63.8235
624	有田	アリタ	1762	624	4369508	63.8492
625	小峰	コミネ	1760	625	4371268	63.8749
626	林田	ハヤシダ	1759	626	4373027	63.9006
627	関谷	セキヤ	1753	627	4374780	63.9263
628	成瀬	ナルセ	1750	628	4376530	63.9518
629	岩下	イワシタ	1747	629	4378277	63.9774
630	滝口	タキグチ	1745	630	4380022	64.0029
631	中根	ナカネ	1738	631	4381760	64.0283
632	塚原	ツカハラ	1734	632	4383494	64.0536
633	堀越	ホリコシ	1733	633	4385227	64.0789
634	石坂	イシザカ	1732	634	4386959	64.1042
635	大庭	オオバ	1727	635	4388686	64.1295
636	川名	カワナ	1727	635	4390413	64.1547
637	佐竹	サタケ	1727	635	4392140	64.1799
638	鳥海	トリウミ	1727	635	4393867	64.2052
639	川辺	カワベ	1718	639	4395585	64.2303
640	岸田	キシダ	1718	639	4397303	64.2554
641	藤森	フジモリ	1715	641	4399018	64.2804
642	植村	ウエムラ	1709	642	4400727	64.3054
643	深沢	フカザワ	1707	643	4402434	64.3304
644	藤巻	フジマキ	1707	643	4404141	64.3553
645	陳	チン	1704	645	4405845	64.3802
646	河本	カワモト	1703	646	4407548	64.4051
647	浅川	アサカワ	1699	647	4409247	64.4299
648	菅	スガ	1695	648	4410942	64.4547
649	神崎	カンザキ	1693	649	4412635	64.4794
650	椎名	シイナ	1690	650	4414325	64.5041
651	浅沼	アサヌマ	1687	651	4416012	64.5288
652	上村	ウエムラ	1685	652	4417697	64.5534
653	鳥居	トリイ	1683	653	4419380	64.578
654	堀井	ホリイ	1683	653	4421063	64.6026
655	添田	ソエダ	1680	655	4422743	64.6271
656	岩間	イワマ	1678	656	4424421	64.6516
657	中島	ナカシマ	1673	657	4426094	64.6761
658	松川	マツカワ	1673	657	4427767	64.7005
659	平塚	ヒラツカ	1669	659	4429436	64.7249
660	瀬川	セガワ	1664	660	4431100	64.7492
661	秋田	アキタ	1662	661	4432762	64.7735
662	目黒	メグロ	1659	662	4434421	64.7978
663	千田	チダ	1658	663	4436079	64.822
664	福永	フクナガ	1657	664	4437736	64.8462
665	水上	ミズカミ	1657	664	4439393	64.8704
666	加納	カノウ	1648	666	4441041	64.8945
667	佐川	サガワ	1647	667	4442688	64.9186
668	永山	ナガヤマ	1647	667	4444335	64.9426
669	梅原	ウメハラ	1643	669	4445978	64.9666
670	宮島	ミヤジマ	1640	670	4447618	64.9906
671	宮■	ミヤザキ	1632	671	4449250	65.0144
672	丹野	タンノ	1630	672	4450880	65.0383
673	西原	ニシハラ	1614	673	4452494	65.0618
674	吉井	ヨシイ	1613	674	4454107	65.0854
675	日野	ヒノ	1609	675	4455716	65.1089
676	富岡	トミオカ	1607	676	4457323	65.1324
677	橘	タチバナ	1604	677	4458927	65.1559
678	平岡	ヒラオカ	1602	678	4460529	65.1793
679	大田	オオタ	1599	679	4462128	65.2026
680	木原	キハラ	1599	679	4463727	65.226
681	高井	タカイ	1593	681	4465320	65.2493
682	吉本	ヨシモト	1588	682	4466908	65.2725
683	北野	キタノ	1584	683	4468492	65.2956
684	■梨	タカナシ	1583	684	4470075	65.3188
685	畑中	ハタナカ	1579	685	4471654	65.3418
686	須山	スヤマ	1577	686	4473231	65.3649
687	柳下	ヤギシタ	1576	687	4474807	65.3879
688	中谷	ナカタニ	1574	688	4476381	65.4109
689	保田	ヤスダ	1574	688	4477955	65.4339
690	鶴岡	ツルオカ	1570	690	4479525	65.4568
691	本橋	モトハシ	1569	691	4481094	65.4798
692	村岡	ムラオカ	1568	692	4482662	65.5027
693	西沢	ニシザワ	1564	693	4484226	65.5255
694	徳田	トクダ	1563	694	4485789	65.5484
695	和泉	イズミ	1561	695	4487350	65.5712
696	板倉	イタクラ	1560	696	4488910	65.594
697	鹿島	カシマ	1560	696	4490470	65.6168
698	海老原	エビハラ	1559	698	4492029	65.6396
699	村瀬	ムラセ	1558	699	4493587	65.6623
700	立川	タチカワ	1556	700	4495143	65.6851
701	武内	タケウチ	1554	701	4496697	65.7078
702	横尾	ヨコオ	1554	701	4498251	65.7305
703	奥野	オクノ	1552	703	4499803	65.7531
704	山岡	ヤマオカ	1541	704	4501344	65.7757
705	角田	カクタ	1539	705	4502883	65.7982
706	平松	ヒラマツ	1531	706	4504414	65.8205
707	片倉	カタクラ	1530	707	4505944	65.8429
708	長谷部	ハセベ	1527	708	4507471	65.8652
709	大滝	オオタキ	1518	709	4508989	65.8874
710	結城	ユウキ	1514	710	4510503	65.9095
711	大坪	オオツボ	1513	711	4512016	65.9316
712	稲田	イナダ	1510	712	4513526	65.9537
713	長沼	ナガヌマ	1508	713	4515034	65.9757
714	宇田川	ウダガワ	1502	714	4516536	65.9977
715	荻原	オギハラ	1497	715	4518033	66.0195
716	深谷	フカヤ	1497	715	4519530	66.0414
717	高島	タカシマ	1495	717	4521025	66.0633
718	細井	ホソイ	1493	718	4522518	66.0851
719	小堀	コボリ	1491	719	4524009	66.1069
720	小原	オハラ	1478	720	4525487	66.1285
721	立花	タチバナ	1478	720	4526965	66.1501
722	藤崎	フジサキ	1478	720	4528443	66.1717
723	橋口	ハシグチ	1471	723	4529914	66.1931
724	門脇	カドワキ	1469	724	4531383	66.2146
725	白鳥	シラトリ	1466	725	4532849	66.236
726	越智	オチ	1463	726	4534312	66.2574
727	市原	イチハラ	1456	727	4535768	66.2787
728	立石	タテイシ	1456	727	4537224	66.3
729	原口	ハラグチ	1455	729	4538679	66.3212
730	常盤	トキワ	1453	730	4540132	66.3425
731	長崎	ナガサキ	1447	731	4541579	66.3636
732	日高	ヒダカ	1446	732	4543025	66.3847
733	金城	キンジヨウ	1444	733	4544469	66.4058
734	小野田	オノダ	1442	734	4545911	66.4269
735	毛利	モウリ	1440	735	4547351	66.4479
736	岩永	イワナガ	1439	736	4548790	66.469
737	岩澤	イワサワ	1432	737	4550222	66.4899
738	平沢	ヒラサワ	1432	737	4551654	66.5108
739	江川	エガワ	1428	739	4553082	66.5317
740	松澤	マツザワ	1421	740	4554503	66.5525
741	伊沢	イザワ	1420	741	4555923	66.5732
742	五味	ゴミ	1419	742	4557342	66.5939
743	小幡	オバタ	1415	743	4558757	66.6146
744	相田	アイダ	1413	744	4560170	66.6353
745	玉井	タマイ	1410	745	4561580	66.6559
746	宮坂	ミヤサカ	1406	746	4562986	66.6764
747	倉持	クラモチ	1402	747	4564388	66.6969
748	黒岩	クロイワ	1402	747	4565790	66.7174
749	野島	ノジマ	1402	747	4567192	66.7379
750	波多野	ハタノ	1402	747	4568594	66.7584
751	清田	キヨタ	1401	751	4569995	66.7788
752	中丸	ナカマル	1401	751	4571396	66.7993
753	牧	マキ	1401	751	4572797	66.8198
754	蒲谷	カバヤ	1398	754	4574195	66.8402
755	菱沼	ヒシヌマ	1396	755	4575591	66.8606
756	大倉	オオクラ	1395	756	4576986	66.881
757	村越	ムラコシ	1395	756	4578381	66.9014
758	寺島	テラシマ	1394	758	4579775	66.9217
759	蛭田	ヒルタ	1391	759	4581166	66.9421
760	綿貫	ワタヌキ	1391	759	4582557	66.9624
761	江成	エナリ	1389	761	4583946	66.9827
762	染谷	ソメヤ	1387	762	4585333	67.003
763	山崎	ヤマサキ	1385	763	4586718	67.0232
764	東海林	シヨウジ	1380	764	4588098	67.0434
765	二瓶	ニヘイ	1379	765	4589477	67.0635
766	香川	カガワ	1378	766	4590855	67.0836
767	板橋	イタバシ	1377	767	4592232	67.1038
768	岩佐	イワサ	1375	768	4593607	67.1239
769	島	シマ	1372	769	4594979	67.1439
770	平	タイラ	1370	770	4596349	67.1639
771	大熊	オオクマ	1367	771	4597716	67.1839
772	小関	コセキ	1367	771	4599083	67.2039
773	井手	イデ	1364	773	4600447	67.2238
774	薄井	ウスイ	1363	774	4601810	67.2437
775	野上	ノガミ	1363	774	4603173	67.2636
776	外山	トヤマ	1362	776	4604535	67.2835
777	椿	ツバキ	1360	777	4605895	67.3034
778	豊島	トヨシマ	1359	778	4607254	67.3233
779	西本	ニシモト	1357	779	4608611	67.3431
780	林	リン	1356	780	4609967	67.3629
781	三沢	ミサワ	1353	781	4611320	67.3827
782	小宮山	コミヤマ	1352	782	4612672	67.4024
783	菅井	スガイ	1349	783	4614021	67.4222
784	猪股	イノマタ	1340	784	4615361	67.4417
785	赤坂	アカサカ	1336	785	4616697	67.4613
786	猪俣	イノマタ	1334	786	4618031	67.4808
787	前原	マエハラ	1333	787	4619364	67.5002
788	大関	オオゼキ	1332	788	4620696	67.5197
789	熊坂	クマサカ	1331	789	4622027	67.5391
790	川合	カワイ	1328	790	4623355	67.5585
791	上杉	ウエスギ	1325	791	4624680	67.5779
792	荻原	オギワラ	1325	791	4626005	67.5973
793	脇	ワキ	1324	793	4627329	67.6166
794	■野	ヨシノ	1321	794	4628650	67.6359
795	大嶋	オオシマ	1319	795	4629969	67.6552
796	加瀬	カセ	1317	796	4631286	67.6744
797	大江	オオエ	1314	797	4632600	67.6936
798	田川	タガワ	1314	797	4633914	67.7128
799	伏見	フシミ	1312	799	4635226	67.732
800	照井	テルイ	1310	800	4636536	67.7512
801	杉村	スギムラ	1308	801	4637844	67.7703
802	三原	ミハラ	1296	802	4639140	67.7892
803	三島	ミシマ	1294	803	4640434	67.8081
804	日下	クサカ	1291	804	4641725	67.827
805	門倉	カドクラ	1287	805	4643012	67.8458
806	秦	ハタ	1287	805	4644299	67.8646
807	川嶋	カワシマ	1286	807	4645585	67.8834
808	今	コン	1282	808	4646867	67.9021
809	高松	タカマツ	1280	809	4648147	67.9208
810	塩田	シオダ	1279	810	4649426	67.9395
811	滝本	タキモト	1279	810	4650705	67.9582
812	三谷	ミタニ	1279	810	4651984	67.9769
813	坂下	サカシタ	1276	813	4653260	67.9955
814	水口	ミズグチ	1276	813	4654536	68.0142
815	梶	カジ	1275	815	4655811	68.0328
816	山室	ヤマムロ	1274	816	4657085	68.0514
817	影山	カゲヤマ	1272	817	4658357	68.07
818	紺野	コンノ	1272	817	4659629	68.0886
819	南雲	ナグモ	1266	819	4660895	68.1071
820	西島	ニシジマ	1265	820	4662160	68.1256
821	芹沢	セリザワ	1260	821	4663420	68.144
822	川畑	カワバタ	1258	822	4664678	68.1624
823	張	チヨウ	1258	822	4665936	68.1808
824	正木	マサキ	1255	824	4667191	68.1991
825	有賀	アリガ	1254	825	4668445	68.2174
826	末永	スエナガ	1253	826	4669698	68.2357
827	栗林	クリバヤシ	1247	827	4670945	68.254
828	浦田	ウラタ	1243	828	4672188	68.2721
829	平賀	ヒラガ	1243	828	4673431	68.2903
830	綾部	アヤベ	1242	830	4674673	68.3084
831	山形	ヤマガタ	1239	831	4675912	68.3265
832	宮野	ミヤノ	1238	832	4677150	68.3446
833	笹原	ササハラ	1237	833	4678387	68.3627
834	関本	セキモト	1236	834	4679623	68.3808
835	小玉	コダマ	1235	835	4680858	68.3988
836	西澤	ニシザワ	1235	835	4682093	68.4169
837	藤澤	フジサワ	1228	837	4683321	68.4348
838	長田	ナガタ	1224	838	4684545	68.4527
839	山上	ヤマガミ	1224	838	4685769	68.4706
840	深沢	フカサワ	1222	840	4686991	68.4884
841	織田	オダ	1221	841	4688212	68.5063
842	氏家	ウジイエ	1220	842	4689432	68.5241
843	梅澤	ウメザワ	1219	843	4690651	68.5419
844	柳原	ヤナギハラ	1218	844	4691869	68.5597
845	村木	ムラキ	1216	845	4693085	68.5775
846	真壁	マカベ	1212	846	4694297	68.5952
847	吉永	ヨシナガ	1211	847	4695508	68.6129
848	大崎	オオサキ	1207	848	4696715	68.6305
849	矢沢	ヤザワ	1205	849	4697920	68.6481
850	橘川	キツカワ	1204	850	4699124	68.6657
851	熊澤	クマザワ	1203	851	4700327	68.6833
852	高村	タカムラ	1200	852	4701527	68.7008
853	高柳	タカヤナギ	1200	852	4702727	68.7184
854	倉本	クラモト	1197	854	4703924	68.7359
855	須藤	ストウ	1197	854	4705121	68.7533
856	柳澤	ヤナギサワ	1196	856	4706317	68.7708
857	川■	カワサキ	1195	857	4707512	68.7883
858	勝俣	カツマタ	1190	858	4708702	68.8057
859	春日	カスガ	1189	859	4709891	68.8231
860	金	キン	1189	859	4711080	68.8404
861	北見	キタミ	1186	861	4712266	68.8578
862	小清水	コシミズ	1184	862	4713450	68.8751
863	柴山	シバヤマ	1184	862	4714634	68.8924
864	藤木	フジキ	1183	864	4715817	68.9096
865	碓井	ウスイ	1182	865	4716999	68.9269
866	江原	エハラ	1182	865	4718181	68.9442
867	八巻	ヤマキ	1181	867	4719362	68.9614
868	神戸	カンベ	1178	868	4720540	68.9787
869	野澤	ノザワ	1178	868	4721718	68.9959
870	池谷	イケヤ	1176	870	4722894	69.0131
871	金山	カナヤマ	1170	871	4724064	69.0302
872	戸塚	トツカ	1168	872	4725232	69.0472
873	上條	カミジヨウ	1162	873	4726394	69.0642
874	金森	カナモリ	1161	874	4727555	69.0812
875	真田	サナダ	1160	875	4728715	69.0981
876	中林	ナカバヤシ	1157	876	4729872	69.115
877	益田	マスダ	1155	877	4731027	69.1319
878	磯野	イソノ	1151	878	4732178	69.1487
879	本山	モトヤマ	1148	879	4733326	69.1655
880	箕輪	ミノワ	1146	880	4734472	69.1822
881	金	キム	1143	881	4735615	69.1989
882	名取	ナトリ	1141	882	4736756	69.2156
883	岩野	イワノ	1140	883	4737896	69.2323
884	福地	フクチ	1140	883	4739036	69.2489
885	松橋	マツハシ	1140	883	4740176	69.2656
886	森岡	モリオカ	1138	886	4741314	69.2822
887	熊倉	クマクラ	1137	887	4742451	69.2988
888	那須	ナス	1136	888	4743587	69.3154
889	■島	タカシマ	1133	889	4744720	69.332
890	岩城	イワキ	1125	890	4745845	69.3484
891	増山	マスヤマ	1124	891	4746969	69.3649
892	石野	イシノ	1121	892	4748090	69.3812
893	矢崎	ヤザキ	1121	892	4749211	69.3976
894	加山	カヤマ	1120	894	4750331	69.414
895	坂元	サカモト	1120	894	4751451	69.4303
896	野原	ノハラ	1117	896	4752568	69.4467
897	三澤	ミサワ	1117	896	4753685	69.463
898	間宮	マミヤ	1116	898	4754801	69.4793
899	松元	マツモト	1115	899	4755916	69.4956
900	■井	タカイ	1113	900	4757029	69.5119
901	中本	ナカモト	1113	900	4758142	69.5281
902	小椋	オグラ	1111	902	4759253	69.5444
903	■村	ヨシムラ	1106	903	4760359	69.5605
904	緑川	ミドリカワ	1105	904	4761464	69.5767
905	大越	オオコシ	1104	905	4762568	69.5928
906	大河原	オオカワラ	1102	906	4763670	69.6089
907	谷川	タニカワ	1101	907	4764771	69.625
908	■瀬	タカセ	1100	908	4765871	69.6411
909	深瀬	フカセ	1099	909	4766970	69.6571
910	寺尾	テラオ	1096	910	4768066	69.6731
911	日比野	ヒビノ	1095	911	4769161	69.6891
912	山城	ヤマシロ	1095	911	4770256	69.7051
913	小山	オヤマ	1094	913	4771350	69.7211
914	杉野	スギノ	1094	913	4772444	69.7371
915	王	オウ	1086	915	4773530	69.753
916	百瀬	モモセ	1086	915	4774616	69.7688
917	下川	シモカワ	1085	917	4775701	69.7847
918	稲村	イナムラ	1081	918	4776782	69.8005
919	室井	ムロイ	1079	919	4777861	69.8163
920	野呂	ノロ	1078	920	4778939	69.832
921	北山	キタヤマ	1077	921	4780016	69.8477
922	森井	モリイ	1075	922	4781091	69.8635
923	柿沼	カキヌマ	1072	923	4782163	69.8791
924	平尾	ヒラオ	1069	924	4783232	69.8947
925	古澤	フルサワ	1069	924	4784301	69.9104
926	米沢	ヨネザワ	1067	926	4785368	69.926
927	須賀	スガ	1065	927	4786433	69.9415
928	仲村	ナカムラ	1065	927	4787498	69.9571
929	古沢	フルサワ	1065	927	4788563	69.9726
930	日下部	クサカベ	1062	930	4789625	69.9882
931	平澤	ヒラサワ	1062	930	4790687	70.0037
932	深田	フカダ	1061	932	4791748	70.0192
933	尾上	オノウエ	1057	933	4792805	70.0346
934	河内	カワウチ	1055	934	4793860	70.05
935	会田	アイダ	1052	935	4794912	70.0654
936	青野	アオノ	1050	936	4795962	70.0808
937	玉木	タマキ	1050	936	4797012	70.0961
938	米倉	ヨネクラ	1048	938	4798060	70.1114
939	城所	キドコロ	1046	939	4799106	70.1267
940	飛田	トビタ	1045	940	4800151	70.142
941	村野	ムラノ	1045	940	4801196	70.1572
942	北沢	キタザワ	1044	942	4802240	70.1725
943	木田	キダ	1043	943	4803283	70.1877
944	前島	マエジマ	1043	943	4804326	70.203
945	鴨志田	カモシダ	1033	945	4805359	70.2181
946	古木	フルキ	1033	945	4806392	70.2332
947	矢吹	ヤブキ	1033	945	4807425	70.2483
948	石丸	イシマル	1032	948	4808457	70.2633
949	菊田	キクタ	1031	949	4809488	70.2784
950	本郷	ホンゴウ	1028	950	4810516	70.2934
951	明石	アカシ	1027	951	4811543	70.3084
952	小山内	オサナイ	1024	952	4812567	70.3234
953	久米	クメ	1023	953	4813590	70.3383
954	金谷	カナヤ	1022	954	4814612	70.3533
955	牧田	マキタ	1022	954	4815634	70.3682
956	相良	サガラ	1020	956	4816654	70.3831
957	関戸	セキド	1020	956	4817674	70.398
958	田邊	タナベ	1019	958	4818693	70.4129
959	広川	ヒロカワ	1019	958	4819712	70.4278
960	笠間	カサマ	1018	960	4820730	70.4427
961	葉山	ハヤマ	1018	960	4821748	70.4576
962	恩田	オンダ	1017	962	4822765	70.4724
963	横川	ヨコカワ	1017	962	4823782	70.4873
964	桐生	キリユウ	1016	964	4824798	70.5021
965	桜田	サクラダ	1016	964	4825814	70.517
966	瀬尾	セオ	1016	964	4826830	70.5318
967	柿崎	カキザキ	1015	967	4827845	70.5466
968	水越	ミズコシ	1015	967	4828860	70.5615
969	浦野	ウラノ	1014	969	4829874	70.5763
970	長塚	ナガツカ	1013	970	4830887	70.5911
971	大畑	オオハタ	1012	971	4831899	70.6059
972	土橋	ドバシ	1012	971	4832911	70.6207
973	岩村	イワムラ	1010	973	4833921	70.6354
974	桐山	キリヤマ	1009	974	4834930	70.6502
975	福士	フクシ	1006	975	4835936	70.6649
976	磯貝	イソガイ	1005	976	4836941	70.6796
977	城田	シロタ	1004	977	4837945	70.6942
978	河田	カワダ	1003	978	4838948	70.7089
979	勝田	カツタ	1001	979	4839949	70.7235
980	北條	ホウジヨウ	1000	980	4840949	70.7381
981	湊	ミナト	998	981	4841947	70.7527
982	粕谷	カスヤ	997	982	4842944	70.7673
983	小山田	オヤマダ	996	983	4843940	70.7818
984	飯村	イイムラ	995	984	4844935	70.7964
985	谷本	タニモト	995	984	4845930	70.8109
986	橋爪	ハシヅメ	994	986	4846924	70.8254
987	羽鳥	ハトリ	994	986	4847918	70.84
988	梶山	カジヤマ	989	988	4848907	70.8544
989	木島	キジマ	989	988	4849896	70.8689
990	草柳	クサヤナギ	989	988	4850885	70.8833
991	増井	マスイ	988	991	4851873	70.8978
992	狩野	カノウ	987	992	4852860	70.9122
993	木戸	キド	986	993	4853846	70.9266
994	富沢	トミザワ	983	994	4854829	70.9409
995	塩沢	シオザワ	977	995	4855806	70.9552
996	保科	ホシナ	977	995	4856783	70.9695
997	丸田	マルタ	977	995	4857760	70.9838
998	柴崎	シバザキ	975	998	4858735	70.998
999	飯山	イイヤマ	973	999	4859708	71.0122
1000	富山	トミヤマ	970	1000	4860678	71.0264
1001	内村	ウチムラ	966	1001	4861644	71.0405
1002	湯山	ユヤマ	965	1002	4862609	71.0546
1003	藤島	フジシマ	963	1003	4863572	71.0687
1004	山野	ヤマノ	963	1003	4864535	71.0828
1005	熊田	クマダ	962	1005	4865497	71.0968
1006	島津	シマヅ	962	1005	4866459	71.1109
1007	永瀬	ナガセ	962	1005	4867421	71.1249
1008	黒崎	クロサキ	960	1008	4868381	71.139
1009	■岡	ヨシオカ	959	1009	4869340	71.153
1010	伊澤	イザワ	958	1010	4870298	71.167
1011	漆原	ウルシバラ	956	1011	4871254	71.181
1012	福嶋	フクシマ	954	1012	4872208	71.1949
1013	塩川	シオカワ	952	1013	4873160	71.2088
1014	深井	フカイ	951	1014	4874111	71.2227
1015	藤江	フジエ	951	1014	4875062	71.2366
1016	花井	ハナイ	949	1016	4876011	71.2505
1017	倉橋	クラハシ	948	1017	4876959	71.2643
1018	三留	ミトメ	948	1017	4877907	71.2782
1019	早野	ハヤノ	947	1019	4878854	71.292
1020	斉木	サイキ	946	1020	4879800	71.3058
1021	高崎	タカサキ	946	1020	4880746	71.3197
1022	長坂	ナガサカ	946	1020	4881692	71.3335
1023	山元	ヤマモト	946	1020	4882638	71.3473
1024	小久保	コクボ	945	1024	4883583	71.3611
1025	比留川	ヒルカワ	945	1024	4884528	71.3749
1026	夏目	ナツメ	944	1026	4885472	71.3887
1027	深澤	フカザワ	940	1027	4886412	71.4025
1028	海野	ウミノ	938	1028	4887350	71.4162
1029	小畑	オバタ	938	1028	4888288	71.4299
1030	榊	サカキ	938	1028	4889226	71.4436
1031	田上	タガミ	938	1028	4890164	71.4573
1032	石塚	イシズカ	937	1032	4891101	71.471
1033	田丸	タマル	937	1032	4892038	71.4847
1034	藤平	フジヒラ	937	1032	4892975	71.4984
1035	草間	クサマ	935	1035	4893910	71.512
1036	浜口	ハマグチ	934	1036	4894844	71.5257
1037	新藤	シンドウ	932	1037	4895776	71.5393
1038	田沢	タザワ	932	1037	4896708	71.5529
1039	小松原	コマツバラ	931	1039	4897639	71.5665
1040	小暮	コグレ	926	1040	4898565	71.58
1041	人見	ヒトミ	925	1041	4899490	71.5936
1042	石岡	イシオカ	924	1042	4900414	71.6071
1043	笹川	ササガワ	924	1042	4901338	71.6206
1044	木本	キモト	922	1044	4902260	71.634
1045	郡司	グンジ	921	1045	4903181	71.6475
1046	石倉	イシクラ	919	1046	4904100	71.6609
1047	北田	キタダ	919	1046	4905019	71.6743
1048	川越	カワゴエ	918	1048	4905937	71.6878
1049	塩谷	シオヤ	917	1049	4906854	71.7012
1050	川田	カワタ	916	1050	4907770	71.7145
1051	小野沢	オノザワ	915	1051	4908685	71.7279
1052	北澤	キタザワ	915	1051	4909600	71.7413
1053	竹原	タケハラ	915	1051	4910515	71.7547
1054	斉田	サイタ	914	1054	4911429	71.768
1055	澁谷	シブヤ	913	1055	4912342	71.7814
1056	鶴見	ツルミ	913	1055	4913255	71.7947
1057	平間	ヒラマ	913	1055	4914168	71.808
1058	生田	イクタ	912	1058	4915080	71.8214
1059	宇都宮	ウツノミヤ	910	1059	4915990	71.8347
1060	笹本	ササモト	907	1060	4916897	71.8479
1061	河西	カサイ	899	1061	4917796	71.8611
1062	楠	クスノキ	897	1062	4918693	71.8742
1063	坂上	サカガミ	897	1062	4919590	71.8873
1064	須永	スナガ	897	1062	4920487	71.9004
1065	仲田	ナカダ	896	1065	4921383	71.9135
1066	加賀谷	カガヤ	895	1066	4922278	71.9265
1067	大泉	オオイズミ	894	1067	4923172	71.9396
1068	小沼	オヌマ	892	1068	4924064	71.9526
1069	高原	タカハラ	892	1068	4924956	71.9657
1070	新堀	シンボリ	891	1070	4925847	71.9787
1071	磯田	イソダ	889	1071	4926736	71.9917
1072	境	サカイ	888	1072	4927624	72.0047
1073	岡島	オカジマ	886	1073	4928510	72.0176
1074	神尾	カミオ	886	1073	4929396	72.0306
1075	寺本	テラモト	884	1075	4930280	72.0435
1076	赤松	アカマツ	883	1076	4931163	72.0564
1077	平良	タイラ	883	1076	4932046	72.0693
1078	久保寺	クボデラ	882	1078	4932928	72.0822
1079	今田	イマダ	881	1079	4933809	72.095
1080	武	タケ	880	1080	4934689	72.1079
1081	湯本	ユモト	880	1080	4935569	72.1208
1082	土居	ドイ	877	1082	4936446	72.1336
1083	磯	イソ	875	1083	4937321	72.1464
1084	真鍋	マナベ	874	1084	4938195	72.1591
1085	古山	フルヤマ	870	1085	4939065	72.1718
1086	大浦	オオウラ	869	1086	4939934	72.1845
1087	大坂	オオサカ	869	1086	4940803	72.1972
1088	二階堂	ニカイドウ	868	1088	4941671	72.2099
1089	西脇	ニシワキ	868	1088	4942539	72.2226
1090	押田	オシダ	866	1090	4943405	72.2353
1091	小田切	オダギリ	866	1090	4944271	72.2479
1092	川又	カワマタ	866	1090	4945137	72.2606
1093	野地	ノジ	866	1090	4946003	72.2732
1094	猪狩	イガリ	863	1094	4946866	72.2858
1095	■村	タカムラ	862	1095	4947728	72.2984
1096	田澤	タザワ	862	1095	4948590	72.311
1097	田渕	タブチ	860	1097	4949450	72.3236
1098	飯塚	イイズカ	859	1098	4950309	72.3361
1099	鎌田	カマダ	858	1099	4951167	72.3487
1100	田崎	タザキ	858	1099	4952025	72.3612
1101	大高	オオタカ	857	1101	4952882	72.3737
1102	神	ジン	856	1102	4953738	72.3863
1103	小栗	オグリ	854	1103	4954592	72.3987
1104	長谷	ハセ	853	1104	4955445	72.4112
1105	■原	ヨシハラ	853	1104	4956298	72.4237
1106	水田	ミズタ	851	1106	4957149	72.4361
1107	田嶋	タジマ	850	1107	4957999	72.4485
1108	田端	タバタ	850	1107	4958849	72.4609
1109	宮脇	ミヤワキ	849	1109	4959698	72.4733
1110	野尻	ノジリ	848	1110	4960546	72.4857
1111	末吉	スエヨシ	847	1111	4961393	72.4981
1112	大林	オオバヤシ	846	1112	4962239	72.5105
1113	■松	タカマツ	846	1112	4963085	72.5228
1114	小原	コハラ	845	1114	4963930	72.5352
1115	矢澤	ヤザワ	845	1114	4964775	72.5475
1116	若月	ワカツキ	845	1114	4965620	72.5599
1117	嘉山	カヤマ	844	1117	4966464	72.5722
1118	坂野	サカノ	844	1117	4967308	72.5845
1119	玉川	タマガワ	844	1117	4968152	72.5969
1120	若山	ワカヤマ	844	1117	4968996	72.6092
1121	井沢	イザワ	841	1121	4969837	72.6215
1122	高岡	タカオカ	841	1121	4970678	72.6338
1123	直井	ナオイ	841	1121	4971519	72.6461
1124	花岡	ハナオカ	841	1121	4972360	72.6584
1125	谷川	タニガワ	840	1125	4973200	72.6706
1126	平原	ヒラハラ	840	1125	4974040	72.6829
1127	本村	モトムラ	838	1127	4974878	72.6952
1128	加賀	カガ	837	1128	4975715	72.7074
1129	芹澤	セリザワ	837	1128	4976552	72.7196
1130	塙	ハナワ	836	1130	4977388	72.7318
1131	石沢	イシザワ	834	1131	4978222	72.744
1132	室伏	ムロフシ	833	1132	4979055	72.7562
1133	嶋村	シマムラ	832	1133	4979887	72.7684
1134	川久保	カワクボ	830	1134	4980717	72.7805
1135	大和	ヤマト	828	1135	4981545	72.7926
1136	飯沼	イイヌマ	827	1136	4982372	72.8047
1137	鳴海	ナルミ	826	1137	4983198	72.8167
1138	浅岡	アサオカ	825	1138	4984023	72.8288
1139	石本	イシモト	825	1138	4984848	72.8408
1140	深野	フカノ	822	1140	4985670	72.8529
1141	滝田	タキタ	821	1141	4986491	72.8649
1142	冨永	トミナガ	821	1141	4987312	72.8769
1143	八田	ハツタ	821	1141	4988133	72.8888
1144	船木	フナキ	821	1141	4988954	72.9008
1145	仲野	ナカノ	820	1145	4989774	72.9128
1146	大宮	オオミヤ	819	1146	4990593	72.9248
1147	都築	ツヅキ	819	1146	4991412	72.9368
1148	土方	ヒジカタ	813	1148	4992225	72.9486
1149	渥美	アツミ	812	1149	4993037	72.9605
1150	勝山	カツヤマ	812	1149	4993849	72.9724
1151	土谷	ツチヤ	812	1149	4994661	72.9842
1152	岡山	オカヤマ	811	1152	4995472	72.9961
1153	越川	コシカワ	810	1153	4996282	73.0079
1154	長山	ナガヤマ	810	1153	4997092	73.0198
1155	赤池	アカイケ	807	1155	4997899	73.0316
1156	島袋	シマブクロ	807	1155	4998706	73.0433
1157	尾■	オザキ	806	1157	4999512	73.0551
1158	城戸	キド	805	1158	5000317	73.0669
1159	一ノ瀬	イチノセ	804	1159	5001121	73.0786
1160	品川	シナガワ	804	1159	5001925	73.0904
1161	古橋	フルハシ	804	1159	5002729	73.1021
1162	深澤	フカサワ	803	1162	5003532	73.1139
1163	小平	コダイラ	801	1163	5004333	73.1256
1164	佐山	サヤマ	798	1164	5005131	73.1372
1165	寺内	テラウチ	797	1165	5005928	73.1489
1166	須貝	スガイ	794	1166	5006722	73.1605
1167	井原	イハラ	793	1167	5007515	73.1721
1168	梅本	ウメモト	793	1167	5008308	73.1837
1169	軽部	カルベ	793	1167	5009101	73.1952
1170	宗像	ムナカタ	792	1170	5009893	73.2068
1171	辻村	ツジムラ	791	1171	5010684	73.2184
1172	奥	オク	789	1172	5011473	73.2299
1173	笹野	ササノ	789	1172	5012262	73.2414
1174	伴	バン	789	1172	5013051	73.253
1175	小熊	オグマ	788	1175	5013839	73.2645
1176	石渡	イシワタリ	785	1176	5014624	73.2759
1177	伊達	ダテ	783	1177	5015407	73.2874
1178	川添	カワゾエ	781	1178	5016188	73.2988
1179	阪本	サカモト	781	1178	5016969	73.3102
1180	伊勢	イセ	779	1180	5017748	73.3216
1181	品田	シナダ	779	1180	5018527	73.333
1182	石村	イシムラ	776	1182	5019303	73.3443
1183	竹山	タケヤマ	776	1182	5020079	73.3557
1184	金野	コンノ	775	1184	5020854	73.367
1185	高杉	タカスギ	774	1185	5021628	73.3783
1186	星川	ホシカワ	774	1185	5022402	73.3896
1187	矢田	ヤダ	774	1185	5023176	73.4009
1188	桑田	クワタ	771	1188	5023947	73.4122
1189	小柴	コシバ	771	1188	5024718	73.4234
1190	鈴野	スズノ	770	1190	5025488	73.4347
1191	矢作	ヤハギ	770	1190	5026258	73.4459
1192	長浜	ナガハマ	769	1192	5027027	73.4572
1193	門馬	モンマ	769	1192	5027796	73.4684
1194	柳沼	ヤギヌマ	767	1194	5028563	73.4796
1195	山浦	ヤマウラ	767	1194	5029330	73.4908
1196	池内	イケウチ	766	1196	5030096	73.502
1197	金丸	カナマル	763	1197	5030859	73.5132
1198	稲毛	イナゲ	762	1198	5031621	73.5243
1199	内海	ウチウミ	762	1198	5032383	73.5354
1200	中込	ナカゴメ	762	1198	5033145	73.5466
1201	深川	フカガワ	762	1198	5033907	73.5577
1202	三瓶	サンペイ	761	1202	5034668	73.5688
1203	井村	イムラ	759	1203	5035427	73.5799
1204	竹井	タケイ	758	1204	5036185	73.591
1205	綱島	ツナシマ	758	1204	5036943	73.6021
1206	日■	ヒダカ	758	1204	5037701	73.6132
1207	澤	サワ	757	1207	5038458	73.6242
1208	寺沢	テラサワ	754	1208	5039212	73.6352
1209	乾	イヌイ	753	1209	5039965	73.6462
1210	八木下	ヤギシタ	751	1210	5040716	73.6572
1211	寺井	テライ	750	1211	5041466	73.6682
1212	春山	ハルヤマ	750	1211	5042216	73.6791
1213	井澤	イザワ	749	1213	5042965	73.6901
1214	羽田	ハダ	749	1213	5043714	73.701
1215	佐原	サハラ	747	1215	5044461	73.7119
1216	松林	マツバヤシ	747	1215	5045208	73.7229
1217	梅津	ウメヅ	746	1217	5045954	73.7338
1218	浜	ハマ	746	1217	5046700	73.7447
1219	黒沼	クロヌマ	745	1219	5047445	73.7555
1220	滝	タキ	745	1219	5048190	73.7664
1221	篠塚	シノヅカ	744	1221	5048934	73.7773
1222	間瀬	マセ	744	1221	5049678	73.7882
1223	矢嶋	ヤジマ	744	1221	5050422	73.799
1224	池谷	イケタニ	743	1224	5051165	73.8099
1225	坂間	サカマ	743	1224	5051908	73.8208
1226	南部	ナンブ	741	1226	5052649	73.8316
1227	関山	セキヤマ	740	1227	5053389	73.8424
1228	北	キタ	739	1228	5054128	73.8532
1229	小寺	コデラ	739	1228	5054867	73.864
1230	田尻	タジリ	739	1228	5055606	73.8748
1231	対馬	ツシマ	738	1231	5056344	73.8856
1232	長内	オサナイ	735	1232	5057079	73.8963
1233	清野	キヨノ	734	1233	5057813	73.907
1234	小沼	コヌマ	734	1233	5058547	73.9178
1235	砂川	スナガワ	733	1235	5059280	73.9285
1236	前野	マエノ	733	1235	5060013	73.9392
1237	児島	コジマ	732	1237	5060745	73.9499
1238	篠■	シノザキ	732	1237	5061477	73.9606
1239	小野塚	オノヅカ	731	1239	5062208	73.9713
1240	米澤	ヨネザワ	731	1239	5062939	73.9819
1241	有村	アリムラ	729	1241	5063668	73.9926
1242	海老沢	エビサワ	729	1241	5064397	74.0033
1243	清田	セイタ	729	1241	5065126	74.0139
1244	脇田	ワキタ	729	1241	5065855	74.0246
1245	柳瀬	ヤナセ	728	1245	5066583	74.0352
1246	西谷	ニシタニ	727	1246	5067310	74.0458
1247	塚越	ツカゴシ	726	1247	5068036	74.0564
1248	安川	ヤスカワ	726	1247	5068762	74.067
1249	梅津	ウメツ	725	1249	5069487	74.0776
1250	時田	トキタ	724	1250	5070211	74.0882
1251	今西	イマニシ	723	1251	5070934	74.0988
1252	藤山	フジヤマ	723	1251	5071657	74.1093
1253	丸岡	マルオカ	723	1251	5072380	74.1199
1254	小竹	コタケ	722	1254	5073102	74.1305
1255	山■	ヤマサキ	721	1255	5073823	74.141
1256	沖	オキ	720	1256	5074543	74.1515
1257	梅村	ウメムラ	718	1257	5075261	74.162
1258	園部	ソノベ	718	1257	5075979	74.1725
1259	塩崎	シオザキ	717	1259	5076696	74.183
1260	峯岸	ミネギシ	717	1259	5077413	74.1934
1261	三富	ミトミ	714	1261	5078127	74.2039
1262	萩野	ハギノ	713	1262	5078840	74.2143
1263	武山	タケヤマ	712	1263	5079552	74.2247
1264	小黒	オグロ	711	1264	5080263	74.2351
1265	遊佐	ユサ	711	1264	5080974	74.2455
1266	江田	エダ	710	1266	5081684	74.2559
1267	赤間	アカマ	709	1267	5082393	74.2662
1268	船山	フナヤマ	709	1267	5083102	74.2766
1269	吉崎	ヨシザキ	709	1267	5083811	74.2869
1270	吉川	キツカワ	708	1270	5084519	74.2973
1271	新保	シンボ	708	1270	5085227	74.3076
1272	井川	イカワ	707	1272	5085934	74.318
1273	福沢	フクザワ	706	1273	5086640	74.3283
1274	原島	ハラシマ	705	1274	5087345	74.3386
1275	川西	カワニシ	703	1275	5088048	74.3489
1276	赤羽	アカバネ	701	1276	5088749	74.3591
1277	茂木	モテギ	701	1276	5089450	74.3693
1278	増渕	マスブチ	700	1278	5090150	74.3796
1279	赤木	アカギ	699	1279	5090849	74.3898
1280	中塚	ナカツカ	699	1279	5091548	74.4
1281	駒井	コマイ	698	1281	5092246	74.4102
1282	柴崎	シバサキ	698	1281	5092944	74.4204
1283	唐沢	カラサワ	697	1283	5093641	74.4306
1284	鮫島	サメジマ	697	1283	5094338	74.4408
1285	守谷	モリヤ	697	1283	5095035	74.4509
1286	元木	モトキ	695	1286	5095730	74.4611
1287	国井	クニイ	694	1287	5096424	74.4712
1288	小金井	コガネイ	694	1287	5097118	74.4814
1289	澤井	サワイ	694	1287	5097812	74.4915
1290	増子	マスコ	694	1287	5098506	74.5017
1291	森永	モリナガ	694	1287	5099200	74.5118
1292	大岡	オオオカ	693	1292	5099893	74.5219
1293	沖田	オキタ	691	1293	5100584	74.532
1294	小口	オグチ	691	1293	5101275	74.5421
1295	大堀	オオホリ	690	1295	5101965	74.5522
1296	真野	マノ	690	1295	5102655	74.5623
1297	青島	アオシマ	688	1297	5103343	74.5723
1298	加茂	カモ	688	1297	5104031	74.5824
1299	坪田	ツボタ	688	1297	5104719	74.5925
1300	石毛	イシゲ	687	1300	5105406	74.6025
1301	穂坂	ホサカ	687	1300	5106093	74.6125
1302	里見	サトミ	686	1302	5106779	74.6226
1303	森野	モリノ	686	1302	5107465	74.6326
1304	田沼	タヌマ	683	1304	5108148	74.6426
1305	松坂	マツザカ	683	1304	5108831	74.6525
1306	久野	クノ	682	1306	5109513	74.6625
1307	武石	タケイシ	682	1306	5110195	74.6725
1308	八幡	ヤハタ	680	1308	5110875	74.6824
1309	小磯	コイソ	679	1309	5111554	74.6923
1310	石澤	イシザワ	678	1310	5112232	74.7022
1311	大須賀	オオスガ	677	1311	5112909	74.7121
1312	豊田	トヨタ	677	1311	5113586	74.722
1313	桜庭	サクラバ	676	1313	5114262	74.7319
1314	塩野	シオノ	676	1313	5114938	74.7418
1315	関田	セキタ	676	1313	5115614	74.7517
1316	沖山	オキヤマ	675	1316	5116289	74.7615
1317	籾山	モミヤマ	675	1316	5116964	74.7714
1318	柳井	ヤナイ	675	1316	5117639	74.7812
1319	喜多	キタ	674	1319	5118313	74.7911
1320	塩田	シオタ	674	1319	5118987	74.8009
1321	坂巻	サカマキ	673	1321	5119660	74.8108
1322	芦川	アシカワ	672	1322	5120332	74.8206
1323	関水	セキミズ	671	1323	5121003	74.8304
1324	狩野	カリノ	670	1324	5121673	74.8402
1325	森口	モリグチ	670	1324	5122343	74.85
1326	重松	シゲマツ	668	1326	5123011	74.8597
1327	高見	タカミ	668	1326	5123679	74.8695
1328	辻本	ツジモト	668	1326	5124347	74.8793
1329	藤原	フジハラ	668	1326	5125015	74.889
1330	宮村	ミヤムラ	668	1326	5125683	74.8988
1331	持丸	モチマル	668	1326	5126351	74.9086
1332	小塚	コヅカ	667	1332	5127018	74.9183
1333	海野	ウンノ	666	1333	5127684	74.928
1334	西條	サイジヨウ	666	1333	5128350	74.9378
1335	瀧澤	タキザワ	666	1333	5129016	74.9475
1336	安岡	ヤスオカ	666	1333	5129682	74.9572
1337	戸村	トムラ	665	1337	5130347	74.9669
1338	平石	ヒライシ	664	1338	5131011	74.9766
1339	河口	カワグチ	663	1339	5131674	74.9863
1340	滝川	タキガワ	663	1339	5132337	74.996
1341	古市	フルイチ	663	1339	5133000	75.0057
1342	大河内	オオコウチ	662	1342	5133662	75.0154
1343	田邉	タナベ	662	1342	5134324	75.0251
1344	向山	ムコウヤマ	661	1344	5134985	75.0347
1345	高尾	タカオ	659	1345	5135644	75.0443
1346	平戸	ヒラト	659	1345	5136303	75.054
1347	松■	マツザキ	659	1345	5136962	75.0636
1348	岡■	オカザキ	657	1348	5137619	75.0732
1349	白岩	シライワ	657	1348	5138276	75.0828
1350	宇田	ウダ	656	1350	5138932	75.0924
1351	野間	ノマ	655	1351	5139587	75.102
1352	宮嶋	ミヤジマ	655	1351	5140242	75.1115
1353	三川	ミカワ	654	1353	5140896	75.1211
1354	柴	シバ	653	1354	5141549	75.1306
1355	一柳	イチヤナギ	652	1355	5142201	75.1402
1356	神林	カンバヤシ	651	1356	5142852	75.1497
1357	成井	ナルイ	651	1356	5143503	75.1592
1358	廣川	ヒロカワ	651	1356	5144154	75.1687
1359	広沢	ヒロサワ	648	1359	5144802	75.1782
1360	池本	イケモト	647	1360	5145449	75.1876
1361	梶原	カジハラ	647	1360	5146096	75.1971
1362	新山	ニイヤマ	647	1360	5146743	75.2065
1363	藤代	フジシロ	647	1360	5147390	75.216
1364	柏原	カシワバラ	646	1364	5148036	75.2254
1365	津久井	ツクイ	646	1364	5148682	75.2349
1366	石上	イシガミ	643	1366	5149325	75.2443
1367	熊野	クマノ	643	1366	5149968	75.2537
1368	我妻	ワガツマ	643	1366	5150611	75.263
1369	赤塚	アカツカ	642	1369	5151253	75.2724
1370	芦沢	アシザワ	642	1369	5151895	75.2818
1371	田山	タヤマ	642	1369	5152537	75.2912
1372	谷村	タニムラ	639	1372	5153176	75.3005
1373	村川	ムラカワ	639	1372	5153815	75.3099
1374	河内	カワチ	638	1374	5154453	75.3192
1375	諸橋	モロハシ	637	1375	5155090	75.3285
1376	小田島	オダジマ	636	1376	5155726	75.3378
1377	羽賀	ハガ	636	1376	5156362	75.3471
1378	藤枝	フジエダ	635	1378	5156997	75.3564
1379	海老塚	エビヅカ	634	1379	5157631	75.3656
1380	滝澤	タキザワ	634	1379	5158265	75.3749
1381	安東	アンドウ	632	1381	5158897	75.3841
1382	井本	イモト	631	1382	5159528	75.3933
1383	国分	コクブ	631	1382	5160159	75.4026
1384	森島	モリシマ	631	1382	5160790	75.4118
1385	小松崎	コマツザキ	630	1385	5161420	75.421
1386	岩見	イワミ	629	1386	5162049	75.4302
1387	河上	カワカミ	628	1387	5162677	75.4394
1388	五島	ゴトウ	628	1387	5163305	75.4485
1389	東條	トウジヨウ	628	1387	5163933	75.4577
1390	楠本	クスモト	627	1390	5164560	75.4669
1391	片平	カタヒラ	626	1391	5165186	75.476
1392	住吉	スミヨシ	624	1392	5165810	75.4851
1393	湯沢	ユザワ	624	1392	5166434	75.4943
1394	国分	コクブン	623	1394	5167057	75.5034
1395	新村	ニイムラ	622	1395	5167679	75.5125
1396	荒	アラ	621	1396	5168300	75.5215
1397	白木	シラキ	621	1396	5168921	75.5306
1398	兼子	カネコ	620	1398	5169541	75.5397
1399	中谷	ナカヤ	620	1398	5170161	75.5487
1400	河井	カワイ	619	1400	5170780	75.5578
1401	平出	ヒライデ	619	1400	5171399	75.5668
1402	■沢	ヨシザワ	619	1400	5172018	75.5759
1403	角井	ツノイ	618	1403	5172636	75.5849
1404	藤倉	フジクラ	618	1403	5173254	75.5939
1405	長友	ナガトモ	616	1405	5173870	75.6029
1406	堀田	ホリタ	615	1406	5174485	75.6119
1407	副島	ソエジマ	614	1407	5175099	75.6209
1408	江崎	エザキ	613	1408	5175712	75.6298
1409	新谷	シンタニ	613	1408	5176325	75.6388
1410	赤井	アカイ	612	1410	5176937	75.6477
1411	岩谷	イワヤ	612	1410	5177549	75.6567
1412	幸田	コウダ	612	1410	5178161	75.6656
1413	長嶺	ナガミネ	612	1410	5178773	75.6746
1414	一戸	イチノヘ	610	1414	5179383	75.6835
1415	中	ナカ	610	1414	5179993	75.6924
1416	香取	カトリ	609	1416	5180602	75.7013
1417	横内	ヨコウチ	609	1416	5181211	75.7102
1418	芦田	アシダ	608	1418	5181819	75.7191
1419	梅木	ウメキ	608	1418	5182427	75.728
1420	栗本	クリモト	608	1418	5183035	75.7368
1421	三堀	ミツボリ	608	1418	5183643	75.7457
1422	嶋崎	シマザキ	607	1422	5184250	75.7546
1423	玉田	タマダ	607	1422	5184857	75.7635
1424	生方	ウブカタ	606	1424	5185463	75.7723
1425	稲川	イナガワ	605	1425	5186068	75.7812
1426	半沢	ハンザワ	605	1425	5186673	75.79
1427	澤村	サワムラ	604	1427	5187277	75.7988
1428	竹之内	タケノウチ	604	1427	5187881	75.8077
1429	今川	イマガワ	603	1429	5188484	75.8165
1430	鎌倉	カマクラ	602	1430	5189086	75.8253
1431	中戸川	ナカトガワ	602	1430	5189688	75.8341
1432	小早川	コバヤカワ	601	1432	5190289	75.8428
1433	込山	コミヤマ	601	1432	5190890	75.8516
1434	陶山	スヤマ	600	1434	5191490	75.8604
1435	久松	ヒサマツ	600	1434	5192090	75.8692
1436	益子	マスコ	600	1434	5192690	75.8779
1437	永松	ナガマツ	599	1437	5193289	75.8867
1438	二本木	ニホンギ	599	1437	5193888	75.8954
1439	安原	ヤスハラ	599	1437	5194487	75.9042
1440	大屋	オオヤ	597	1440	5195084	75.9129
1441	中津川	ナカツガワ	596	1441	5195680	75.9216
1442	仁科	ニシナ	596	1441	5196276	75.9303
1443	見上	ミカミ	596	1441	5196872	75.939
1444	山縣	ヤマガタ	596	1441	5197468	75.9477
1445	黒須	クロス	595	1445	5198063	75.9564
1446	赤石	アカイシ	594	1446	5198657	75.9651
1447	有川	アリカワ	594	1446	5199251	75.9738
1448	久保寺	クボテラ	594	1446	5199845	75.9825
1449	角	スミ	594	1446	5200439	75.9912
1450	鳥羽	トバ	594	1446	5201033	75.9998
1451	村石	ムライシ	594	1446	5201627	76.0085
1452	浜本	ハマモト	593	1452	5202220	76.0172
1453	飯尾	イイオ	592	1453	5202812	76.0258
1454	桑野	クワノ	592	1453	5203404	76.0345
1455	高倉	タカクラ	592	1453	5203996	76.0431
1456	棚橋	タナハシ	592	1453	5204588	76.0518
1457	寺西	テラニシ	592	1453	5205180	76.0604
1458	徳江	トクエ	592	1453	5205772	76.0691
1459	八島	ヤシマ	592	1453	5206364	76.0777
1460	千田	センダ	591	1460	5206955	76.0864
1461	最上	モガミ	591	1460	5207546	76.095
1462	堺	サカイ	590	1462	5208136	76.1036
1463	安永	ヤスナガ	590	1462	5208726	76.1123
1464	神原	カンバラ	589	1464	5209315	76.1209
1465	北井	キタイ	588	1465	5209903	76.1295
1466	坂東	バンドウ	586	1466	5210489	76.138
1467	木川	キガワ	585	1467	5211074	76.1466
1468	石綿	イシワタ	584	1468	5211658	76.1551
1469	浦	ウラ	584	1468	5212242	76.1636
1470	大曽根	オオソネ	584	1468	5212826	76.1722
1471	千野	チノ	584	1468	5213410	76.1807
1472	鄭	テイ	584	1468	5213994	76.1892
1473	西井	ニシイ	584	1468	5214578	76.1978
1474	岩岡	イワオカ	583	1474	5215161	76.2063
1475	黄	コウ	582	1475	5215743	76.2148
1476	矢後	ヤゴ	582	1475	5216325	76.2233
1477	田上	タノウエ	581	1477	5216906	76.2318
1478	大里	オオサト	580	1478	5217486	76.2403
1479	牧山	マキヤマ	580	1478	5218066	76.2487
1480	門間	モンマ	580	1478	5218646	76.2572
1481	生駒	イコマ	579	1481	5219225	76.2657
1482	鍵和田	カギワダ	579	1481	5219804	76.2741
1483	畑山	ハタヤマ	579	1481	5220383	76.2826
1484	兵藤	ヒヨウドウ	579	1481	5220962	76.2911
1485	寺岡	テラオカ	578	1485	5221540	76.2995
1486	日向	ヒナタ	578	1485	5222118	76.3079
1487	友野	トモノ	577	1487	5222695	76.3164
1488	峰尾	ミネオ	577	1487	5223272	76.3248
1489	鷲尾	ワシオ	577	1487	5223849	76.3332
1490	門田	カドタ	576	1490	5224425	76.3417
1491	小形	オガタ	575	1491	5225000	76.3501
1492	塩見	シオミ	575	1491	5225575	76.3585
1493	浅葉	アサバ	574	1493	5226149	76.3668
1494	畠中	ハタナカ	574	1493	5226723	76.3752
1495	折原	オリハラ	573	1495	5227296	76.3836
1496	桂	カツラ	573	1495	5227869	76.392
1497	神野	ジンノ	572	1497	5228441	76.4003
1498	佐瀬	サセ	571	1498	5229012	76.4087
1499	根津	ネヅ	570	1499	5229582	76.417
1500	福元	フクモト	570	1499	5230152	76.4253
1501	萩原	ハギハラ	568	1501	5230720	76.4336
1502	飯嶋	イイジマ	567	1502	5231287	76.4419
1503	引地	ヒキチ	567	1502	5231854	76.4502
1504	串田	クシダ	565	1504	5232419	76.4585
1505	塚越	ツカコシ	565	1504	5232984	76.4667
1506	成川	ナリカワ	565	1504	5233549	76.475
1507	松平	マツダイラ	565	1504	5234114	76.4832
1508	涌井	ワクイ	565	1504	5234679	76.4915
1509	日比	ヒビ	563	1509	5235242	76.4997
1510	安室	ヤスムロ	563	1509	5235805	76.5079
1511	出川	デガワ	562	1511	5236367	76.5162
1512	古瀬	フルセ	562	1511	5236929	76.5244
1513	若杉	ワカスギ	562	1511	5237491	76.5326
1514	関川	セキカワ	560	1514	5238051	76.5408
1515	名倉	ナグラ	560	1514	5238611	76.5489
1516	宮尾	ミヤオ	560	1514	5239171	76.5571
1517	山木	ヤマキ	560	1514	5239731	76.5653
1518	大迫	オオサコ	559	1518	5240290	76.5735
1519	長倉	ナガクラ	559	1518	5240849	76.5816
1520	谷田部	ヤタベ	559	1518	5241408	76.5898
1521	牛島	ウシジマ	558	1521	5241966	76.598
1522	大岩	オオイワ	558	1521	5242524	76.6061
1523	北岡	キタオカ	558	1521	5243082	76.6143
1524	川内	カワウチ	557	1524	5243639	76.6224
1525	劉	リユウ	557	1524	5244196	76.6306
1526	佃	ツクダ	556	1526	5244752	76.6387
1527	仲宗根	ナカソネ	556	1526	5245308	76.6468
1528	野川	ノガワ	556	1526	5245864	76.6549
1529	八代	ヤシロ	556	1526	5246420	76.6631
1530	井坂	イサカ	555	1530	5246975	76.6712
1531	益子	マシコ	555	1530	5247530	76.6793
1532	森脇	モリワキ	555	1530	5248085	76.6874
1533	朝比奈	アサヒナ	554	1533	5248639	76.6955
1534	谷内	タニウチ	554	1533	5249193	76.7036
1535	津村	ツムラ	554	1533	5249747	76.7117
1536	別府	ベツプ	554	1533	5250301	76.7198
1537	森崎	モリサキ	554	1533	5250855	76.7279
1538	湯田	ユダ	554	1533	5251409	76.736
1539	岩堀	イワホリ	553	1539	5251962	76.744
1540	諏訪部	スワベ	553	1539	5252515	76.7521
1541	米川	ヨネカワ	553	1539	5253068	76.7602
1542	浜崎	ハマザキ	552	1542	5253620	76.7683
1543	宮前	ミヤマエ	552	1542	5254172	76.7763
1544	江頭	エガシラ	551	1544	5254723	76.7844
1545	高嶋	タカシマ	550	1545	5255273	76.7924
1546	舘野	タテノ	550	1545	5255823	76.8005
1547	山森	ヤマモリ	550	1545	5256373	76.8085
1548	赤川	アカガワ	549	1548	5256922	76.8165
1549	宍倉	シシクラ	548	1549	5257470	76.8245
1550	岩切	イワキリ	547	1550	5258017	76.8325
1551	清原	キヨハラ	547	1550	5258564	76.8405
1552	小村	コムラ	547	1550	5259111	76.8485
1553	知念	チネン	547	1550	5259658	76.8565
1554	富澤	トミザワ	547	1550	5260205	76.8645
1555	船越	フナコシ	547	1550	5260752	76.8725
1556	水村	ミズムラ	547	1550	5261299	76.8805
1557	糸井	イトイ	546	1557	5261845	76.8885
1558	田宮	タミヤ	546	1557	5262391	76.8964
1559	石島	イシジマ	545	1559	5262936	76.9044
1560	芝田	シバタ	545	1559	5263481	76.9124
1561	若井	ワカイ	545	1559	5264026	76.9203
1562	大■	オオタカ	544	1562	5264570	76.9283
1563	菊川	キクカワ	543	1563	5265113	76.9362
1564	庄子	シヨウジ	543	1563	5265656	76.9441
1565	濱野	ハマノ	543	1563	5266199	76.9521
1566	船津	フナツ	543	1563	5266742	76.96
1567	甘利	アマリ	542	1567	5267284	76.9679
1568	大八木	オオヤギ	542	1567	5267826	76.9758
1569	寺崎	テラサキ	542	1567	5268368	76.9838
1570	宮地	ミヤチ	542	1567	5268910	76.9917
1571	山路	ヤマジ	542	1567	5269452	76.9996
1572	■澤	ヨシザワ	542	1567	5269994	77.0075
1573	梶田	カジタ	541	1573	5270535	77.0154
1574	川戸	カワト	540	1574	5271075	77.0233
1575	西方	ニシカタ	540	1574	5271615	77.0312
1576	江尻	エジリ	539	1576	5272154	77.0391
1577	沢井	サワイ	539	1576	5272693	77.047
1578	水戸	ミト	539	1576	5273232	77.0548
1579	河崎	カワサキ	538	1579	5273770	77.0627
1580	小牧	コマキ	538	1579	5274308	77.0706
1581	市橋	イチハシ	537	1581	5274845	77.0784
1582	大賀	オオガ	537	1581	5275382	77.0863
1583	荘司	シヨウジ	537	1581	5275919	77.0941
1584	能登	ノト	537	1581	5276456	77.102
1585	青田	アオタ	536	1585	5276992	77.1098
1586	沢野	サワノ	536	1585	5277528	77.1176
1587	寺山	テラヤマ	536	1585	5278064	77.1255
1588	冨岡	トミオカ	536	1585	5278600	77.1333
1589	赤堀	アカホリ	535	1589	5279135	77.1411
1590	石森	イシモリ	535	1589	5279670	77.1489
1591	臼田	ウスダ	535	1589	5280205	77.1567
1592	■嶋	タカシマ	535	1589	5280740	77.1646
1593	岩元	イワモト	534	1593	5281274	77.1724
1594	鴫原	シギハラ	534	1593	5281808	77.1802
1595	西口	ニシグチ	534	1593	5282342	77.188
1596	早瀬	ハヤセ	534	1593	5282876	77.1958
1597	北林	キタバヤシ	533	1597	5283409	77.2036
1598	戸部	トベ	533	1597	5283942	77.2113
1599	野■	ノザキ	533	1597	5284475	77.2191
1600	柳田	ヤナギタ	533	1597	5285008	77.2269
1601	永岡	ナガオカ	532	1601	5285540	77.2347
1602	平岩	ヒライワ	532	1601	5286072	77.2425
1603	島野	シマノ	531	1603	5286603	77.2502
1604	竹林	タケバヤシ	531	1603	5287134	77.258
1605	柏崎	カシワザキ	530	1605	5287664	77.2657
1606	門松	カドマツ	530	1605	5288194	77.2735
1607	織茂	オリモ	529	1607	5288723	77.2812
1608	高須	タカス	529	1607	5289252	77.2889
1609	仲川	ナカガワ	529	1607	5289781	77.2967
1610	馬渕	マブチ	529	1607	5290310	77.3044
1611	矢内	ヤナイ	529	1607	5290839	77.3121
1612	高田	タカタ	528	1612	5291367	77.3198
1613	的場	マトバ	528	1612	5291895	77.3276
1614	植野	ウエノ	527	1614	5292422	77.3353
1615	河西	カワニシ	527	1614	5292949	77.343
1616	鹿野	シカノ	527	1614	5293476	77.3507
1617	田崎	タサキ	526	1617	5294002	77.3583
1618	津島	ツシマ	525	1618	5294527	77.366
1619	朝日	アサヒ	524	1619	5295051	77.3737
1620	塩澤	シオザワ	523	1620	5295574	77.3813
1621	平島	ヒラシマ	523	1620	5296097	77.389
1622	市野	イチノ	522	1622	5296619	77.3966
1623	下里	シモザト	522	1622	5297141	77.4042
1624	春田	ハルタ	522	1622	5297663	77.4118
1625	木暮	コグレ	521	1625	5298184	77.4195
1626	端山	ハヤマ	521	1625	5298705	77.4271
1627	柳下	ヤナギシタ	521	1625	5299226	77.4347
1628	柿沢	カキザワ	520	1628	5299746	77.4423
1629	坂倉	サカクラ	520	1628	5300266	77.4499
1630	日吉	ヒヨシ	520	1628	5300786	77.4575
1631	甘粕	アマカス	519	1631	5301305	77.4651
1632	幡野	ハタノ	519	1631	5301824	77.4726
1633	岸野	キシノ	518	1633	5302342	77.4802
1634	新垣	アラカキ	517	1634	5302859	77.4878
1635	今福	イマフク	517	1634	5303376	77.4953
1636	花上	ハナウエ	517	1634	5303893	77.5029
1637	岩倉	イワクラ	516	1637	5304409	77.5104
1638	楊	ヨウ	516	1637	5304925	77.518
1639	黒瀬	クロセ	515	1639	5305440	77.5255
1640	土橋	ツチハシ	515	1639	5305955	77.533
1641	大下	オオシタ	513	1641	5306468	77.5405
1642	北嶋	キタジマ	513	1641	5306981	77.548
1643	蒔田	マキタ	512	1643	5307493	77.5555
1644	疋田	ヒキタ	511	1644	5308004	77.5629
1645	稲本	イナモト	510	1645	5308514	77.5704
1646	河田	カワタ	510	1645	5309024	77.5779
1647	猪瀬	イノセ	509	1647	5309533	77.5853
1648	下地	シモジ	509	1647	5310042	77.5927
1649	丹治	タンジ	509	1647	5310551	77.6002
1650	三田村	ミタムラ	509	1647	5311060	77.6076
1651	村中	ムラナカ	509	1647	5311569	77.615
1652	山梨	ヤマナシ	509	1647	5312078	77.6225
1653	伊丹	イタミ	508	1653	5312586	77.6299
1654	高城	タカギ	508	1653	5313094	77.6373
1655	東郷	トウゴウ	508	1653	5313602	77.6447
1656	松嶋	マツシマ	508	1653	5314110	77.6522
1657	菊地原	キクチハラ	507	1657	5314617	77.6596
1658	小峯	コミネ	507	1657	5315124	77.667
1659	古郡	フルゴオリ	507	1657	5315631	77.6744
1660	宮地	ミヤジ	507	1657	5316138	77.6818
1661	八重樫	ヤエガシ	507	1657	5316645	77.6892
1662	寺澤	テラサワ	506	1662	5317151	77.6966
1663	畑野	ハタノ	506	1662	5317657	77.704
1664	衛藤	エトウ	505	1664	5318162	77.7114
1665	菅田	スガタ	505	1664	5318667	77.7188
1666	■岡	タカオカ	505	1664	5319172	77.7261
1667	井川	イガワ	504	1667	5319676	77.7335
1668	島本	シマモト	504	1667	5320180	77.7409
1669	竹島	タケシマ	504	1667	5320684	77.7482
1670	谷山	タニヤマ	504	1667	5321188	77.7556
1671	玉城	タマシロ	504	1667	5321692	77.763
1672	浜崎	ハマサキ	504	1667	5322196	77.7703
1673	福住	フクズミ	504	1667	5322700	77.7777
1674	島貫	シマヌキ	503	1674	5323203	77.785
1675	小浜	コハマ	502	1675	5323705	77.7924
1676	高畑	タカハタ	502	1675	5324207	77.7997
1677	守田	モリタ	502	1675	5324709	77.807
1678	池野	イケノ	501	1678	5325210	77.8144
1679	関沢	セキザワ	501	1678	5325711	77.8217
1680	長	チヨウ	501	1678	5326212	77.829
1681	手島	テジマ	501	1678	5326713	77.8363
1682	米村	ヨネムラ	501	1678	5327214	77.8437
1683	草薙	クサナギ	500	1683	5327714	77.851
1684	合田	ゴウダ	500	1683	5328214	77.8583
1685	三角	ミスミ	500	1683	5328714	77.8656
1686	水落	ミズオチ	500	1683	5329214	77.8729
1687	由井	ユイ	500	1683	5329714	77.8802
1688	吉見	ヨシミ	500	1683	5330214	77.8875
1689	浅利	アサリ	499	1689	5330713	77.8948
1690	井関	イセキ	499	1689	5331212	77.9021
1691	船橋	フナバシ	499	1689	5331711	77.9094
1692	浅倉	アサクラ	498	1692	5332209	77.9166
1693	磯村	イソムラ	498	1692	5332707	77.9239
1694	梶川	カジカワ	498	1692	5333205	77.9312
1695	熊本	クマモト	497	1695	5333702	77.9385
1696	笹尾	ササオ	497	1695	5334199	77.9457
1697	沢村	サワムラ	497	1695	5334696	77.953
1698	白倉	シラクラ	497	1695	5335193	77.9602
1699	宮	ミヤ	497	1695	5335690	77.9675
1700	猿渡	サルワタリ	496	1700	5336186	77.9748
1701	尾島	オジマ	495	1701	5336681	77.982
1702	蓮見	ハスミ	495	1701	5337176	77.9892
1703	肥後	ヒゴ	495	1701	5337671	77.9965
1704	村尾	ムラオ	495	1701	5338166	78.0037
1705	澤口	サワグチ	493	1705	5338659	78.0109
1706	城	ジヨウ	493	1705	5339152	78.0181
1707	岩橋	イワハシ	492	1707	5339644	78.0253
1708	木口	キグチ	492	1707	5340136	78.0325
1709	鬼頭	キトウ	491	1709	5340627	78.0396
1710	高久	タカク	491	1709	5341118	78.0468
1711	峯	ミネ	491	1709	5341609	78.054
1712	森屋	モリヤ	491	1709	5342100	78.0612
1713	鵜飼	ウカイ	490	1713	5342590	78.0683
1714	田部井	タベイ	490	1713	5343080	78.0755
1715	永嶋	ナガシマ	490	1713	5343570	78.0827
1716	三觜	ミツハシ	490	1713	5344060	78.0898
1717	安倍	アベ	489	1717	5344549	78.097
1718	小口	コグチ	489	1717	5345038	78.1041
1719	嶋	シマ	489	1717	5345527	78.1113
1720	倉島	クラシマ	488	1720	5346015	78.1184
1721	志水	シミズ	488	1720	5346503	78.1255
1722	大杉	オオスギ	487	1722	5346990	78.1326
1723	菅	カン	487	1722	5347477	78.1397
1724	宮永	ミヤナガ	487	1722	5347964	78.1469
1725	牛尾	ウシオ	486	1725	5348450	78.154
1726	岸川	キシカワ	486	1725	5348936	78.1611
1727	塩原	シオバラ	486	1725	5349422	78.1682
1728	高塚	タカツカ	486	1725	5349908	78.1753
1729	鳥山	トリヤマ	486	1725	5350394	78.1824
1730	羽田	ハネダ	486	1725	5350880	78.1895
1731	浜中	ハマナカ	486	1725	5351366	78.1966
1732	松倉	マツクラ	486	1725	5351852	78.2037
1733	浦川	ウラカワ	485	1733	5352337	78.2108
1734	南條	ナンジヨウ	485	1733	5352822	78.2178
1735	村本	ムラモト	485	1733	5353307	78.2249
1736	柴原	シバハラ	484	1736	5353791	78.232
1737	首藤	シユトウ	484	1736	5354275	78.2391
1738	須崎	スザキ	484	1736	5354759	78.2462
1739	渕上	フチガミ	484	1736	5355243	78.2532
1740	小貫	オヌキ	483	1740	5355726	78.2603
1741	吉成	ヨシナリ	483	1740	5356209	78.2673
1742	有泉	アリイズミ	482	1742	5356691	78.2744
1743	助川	スケガワ	481	1743	5357172	78.2814
1744	秦野	ハタノ	481	1743	5357653	78.2884
1745	山脇	ヤマワキ	481	1743	5358134	78.2955
1746	江上	エガミ	480	1746	5358614	78.3025
1747	袴田	ハカマダ	480	1746	5359094	78.3095
1748	土岐	トキ	479	1748	5359573	78.3165
1749	新野	ニイノ	479	1748	5360052	78.3235
1750	猪又	イノマタ	478	1750	5360530	78.3305
1751	宇山	ウヤマ	478	1750	5361008	78.3375
1752	鷹野	タカノ	478	1750	5361486	78.3445
1753	東山	ヒガシヤマ	478	1750	5361964	78.3514
1754	櫛田	クシダ	477	1754	5362441	78.3584
1755	中條	ナカジヨウ	477	1754	5362918	78.3654
1756	西森	ニシモリ	477	1754	5363395	78.3723
1757	久野	ヒサノ	477	1754	5363872	78.3793
1758	宮代	ミヤシロ	477	1754	5364349	78.3863
1759	内川	ウチカワ	476	1759	5364825	78.3932
1760	小岩	コイワ	475	1760	5365300	78.4002
1761	小針	コバリ	475	1760	5365775	78.4071
1762	藤谷	フジタニ	475	1760	5366250	78.4141
1763	犬塚	イヌヅカ	474	1763	5366724	78.421
1764	大串	オオグシ	474	1763	5367198	78.4279
1765	笹田	ササダ	474	1763	5367672	78.4348
1766	逸見	ヘンミ	474	1763	5368146	78.4418
1767	丸尾	マルオ	474	1763	5368620	78.4487
1768	芝	シバ	473	1768	5369093	78.4556
1769	布川	フカワ	473	1768	5369566	78.4625
1770	戸井田	トイダ	472	1770	5370038	78.4694
1771	浅場	アサバ	471	1771	5370509	78.4763
1772	奥原	オクハラ	471	1771	5370980	78.4832
1773	川俣	カワマタ	470	1773	5371450	78.49
1774	笹木	ササキ	470	1773	5371920	78.4969
1775	金丸	カネマル	469	1775	5372389	78.5038
1776	高津	タカツ	469	1775	5372858	78.5106
1777	沼倉	ヌマクラ	469	1775	5373327	78.5175
1778	今野	イマノ	468	1778	5373795	78.5243
1779	瀬戸口	セトグチ	468	1778	5374263	78.5312
1780	水本	ミズモト	468	1778	5374731	78.538
1781	峯尾	ミネオ	468	1778	5375199	78.5448
1782	高林	タカバヤシ	466	1782	5375665	78.5516
1783	室田	ムロタ	466	1782	5376131	78.5584
1784	小田桐	オダギリ	465	1784	5376596	78.5652
1785	平木	ヒラキ	465	1784	5377061	78.572
1786	伊原	イハラ	464	1786	5377525	78.5788
1787	今関	イマゼキ	464	1786	5377989	78.5856
1788	仙波	センバ	464	1786	5378453	78.5924
1789	柘植	ツゲ	464	1786	5378917	78.5992
1790	入沢	イリサワ	463	1790	5379380	78.6059
1791	小野瀬	オノセ	463	1790	5379843	78.6127
1792	力石	チカライシ	463	1790	5380306	78.6195
1793	鳥越	トリゴエ	463	1790	5380769	78.6262
1794	熊木	クマキ	462	1794	5381231	78.633
1795	仙田	センダ	462	1794	5381693	78.6397
1796	石津	イシヅ	461	1796	5382154	78.6465
1797	上岡	カミオカ	461	1796	5382615	78.6532
1798	多賀	タガ	461	1796	5383076	78.6599
1799	中森	ナカモリ	460	1799	5383536	78.6667
1800	妹尾	セノオ	459	1800	5383995	78.6734
1801	高沢	タカザワ	459	1800	5384454	78.6801
1802	永塚	ナガツカ	459	1800	5384913	78.6868
1803	深見	フカミ	459	1800	5385372	78.6935
1804	友田	トモダ	458	1804	5385830	78.7002
1805	西崎	ニシザキ	458	1804	5386288	78.7069
1806	能勢	ノセ	458	1804	5386746	78.7136
1807	青沼	アオヌマ	457	1807	5387203	78.7202
1808	浦山	ウラヤマ	457	1807	5387660	78.7269
1809	蝦名	エビナ	457	1807	5388117	78.7336
1810	坂上	サカウエ	457	1807	5388574	78.7403
1811	谷田	タニダ	457	1807	5389031	78.747
1812	鍋島	ナベシマ	457	1807	5389488	78.7536
1813	竹川	タケカワ	456	1813	5389944	78.7603
1814	山谷	ヤマヤ	456	1813	5390400	78.767
1815	猪野	イノ	455	1815	5390855	78.7736
1816	牛山	ウシヤマ	455	1815	5391310	78.7803
1817	坂	サカ	455	1815	5391765	78.7869
1818	岡安	オカヤス	454	1818	5392219	78.7935
1819	角田	カクダ	453	1819	5392672	78.8002
1820	桑山	クワヤマ	453	1819	5393125	78.8068
1821	新川	シンカワ	453	1819	5393578	78.8134
1822	吉武	ヨシタケ	453	1819	5394031	78.82
1823	若狭	ワカサ	453	1819	5394484	78.8266
1824	有山	アリヤマ	452	1824	5394936	78.8332
1825	板谷	イタヤ	452	1824	5395388	78.8398
1826	瀬谷	セヤ	452	1824	5395840	78.8464
1827	照屋	テルヤ	452	1824	5396292	78.8531
1828	土肥	ドヒ	452	1824	5396744	78.8597
1829	田子	タゴ	451	1829	5397195	78.8662
1830	本庄	ホンジヨウ	451	1829	5397646	78.8728
1831	神部	カンベ	450	1831	5398096	78.8794
1832	半澤	ハンザワ	450	1831	5398546	78.886
1833	大隅	オオスミ	449	1833	5398995	78.8925
1834	呉	ゴ	449	1833	5399444	78.8991
1835	平沼	ヒラヌマ	449	1833	5399893	78.9057
1836	堀之内	ホリノウチ	449	1833	5400342	78.9122
1837	前山	マエヤマ	449	1833	5400791	78.9188
1838	新城	シンジヨウ	447	1838	5401238	78.9253
1839	寺門	テラカド	446	1839	5401684	78.9318
1840	土志田	ドシダ	446	1839	5402130	78.9384
1841	近江	オオミ	445	1841	5402575	78.9449
1842	下野	シモノ	445	1841	5403020	78.9514
1843	代田	シロタ	445	1841	5403465	78.9579
1844	白坂	シラサカ	444	1844	5403909	78.9644
1845	手島	テシマ	444	1844	5404353	78.9708
1846	戸川	トガワ	444	1844	5404797	78.9773
1847	徳山	トクヤマ	444	1844	5405241	78.9838
1848	富井	トミイ	444	1844	5405685	78.9903
1849	飛田	ヒダ	444	1844	5406129	78.9968
1850	丸茂	マルモ	444	1844	5406573	79.0033
1851	蓑島	ミノシマ	444	1844	5407017	79.0098
1852	望月	モチズキ	444	1844	5407461	79.0163
1853	譲原	ユズリハラ	444	1844	5407905	79.0227
1854	澤野	サワノ	443	1854	5408348	79.0292
1855	真下	マシモ	443	1854	5408791	79.0357
1856	一瀬	イチノセ	442	1856	5409233	79.0422
1857	荻田	オギタ	441	1857	5409674	79.0486
1858	上山	カミヤマ	441	1857	5410115	79.055
1859	木曽	キソ	441	1857	5410556	79.0615
1860	古宮	コミヤ	441	1857	5410997	79.0679
1861	兵頭	ヒヨウドウ	441	1857	5411438	79.0744
1862	柿本	カキモト	440	1862	5411878	79.0808
1863	狩野	カノ	440	1862	5412318	79.0872
1864	笹岡	ササオカ	440	1862	5412758	79.0937
1865	玉置	タマオキ	440	1862	5413198	79.1001
1866	穂積	ホヅミ	439	1866	5413637	79.1065
1867	小方	オガタ	438	1867	5414075	79.1129
1868	只野	タダノ	438	1867	5414513	79.1193
1869	一色	イツシキ	437	1869	5414950	79.1257
1870	臼居	ウスイ	437	1869	5415387	79.1321
1871	舟山	フナヤマ	436	1871	5415823	79.1384
1872	若尾	ワカオ	436	1871	5416259	79.1448
1873	赤尾	アカオ	435	1873	5416694	79.1512
1874	橘田	キツタ	435	1873	5417129	79.1575
1875	迫田	サコダ	435	1873	5417564	79.1639
1876	高森	タカモリ	435	1873	5417999	79.1702
1877	早田	ハヤタ	435	1873	5418434	79.1766
1878	桐原	キリハラ	434	1878	5418868	79.1829
1879	井野	イノ	433	1879	5419301	79.1893
1880	砂田	スナダ	433	1879	5419734	79.1956
1881	杉崎	スギサキ	432	1881	5420166	79.2019
1882	■倉	タカクラ	432	1881	5420598	79.2082
1883	所	トコロ	432	1881	5421030	79.2145
1884	中岡	ナカオカ	432	1881	5421462	79.2208
1885	両角	モロズミ	432	1881	5421894	79.2272
1886	一條	イチジヨウ	431	1886	5422325	79.2335
1887	久我	クガ	431	1886	5422756	79.2398
1888	寺島	テラジマ	431	1886	5423187	79.2461
1889	橋詰	ハシヅメ	431	1886	5423618	79.2524
1890	崎山	サキヤマ	430	1890	5424048	79.2586
1891	深津	フカツ	430	1890	5424478	79.2649
1892	松谷	マツタニ	430	1890	5424908	79.2712
1893	峰岸	ミネギシ	430	1890	5425338	79.2775
1894	君島	キミシマ	429	1894	5425767	79.2838
1895	寒河江	サガエ	429	1894	5426196	79.29
1896	首藤	シユドウ	429	1894	5426625	79.2963
1897	杉■	スギザキ	429	1894	5427054	79.3026
1898	本杉	モトスギ	429	1894	5427483	79.3088
1899	山之内	ヤマノウチ	428	1899	5427911	79.3151
1900	金本	カネモト	427	1900	5428338	79.3213
1901	福澤	フクザワ	427	1900	5428765	79.3276
1902	相場	アイバ	426	1902	5429191	79.3338
1903	大渕	オオブチ	426	1902	5429617	79.34
1904	熊井	クマイ	425	1904	5430042	79.3462
1905	玉城	タマキ	425	1904	5430467	79.3524
1906	冨樫	トガシ	425	1904	5430892	79.3586
1907	広野	ヒロノ	425	1904	5431317	79.3649
1908	入澤	イリサワ	424	1908	5431741	79.371
1909	大類	オオルイ	424	1908	5432165	79.3772
1910	関原	セキハラ	424	1908	5432589	79.3834
1911	■柳	タカヤナギ	424	1908	5433013	79.3896
1912	田坂	タサカ	424	1908	5433437	79.3958
1913	中溝	ナカミゾ	424	1908	5433861	79.402
1914	小高	コダカ	423	1914	5434284	79.4082
1915	松葉	マツバ	423	1914	5434707	79.4144
1916	山野井	ヤマノイ	423	1914	5435130	79.4206
1917	高部	タカベ	422	1917	5435552	79.4267
1918	丹	タン	422	1917	5435974	79.4329
1919	桧山	ヒヤマ	422	1917	5436396	79.4391
1920	加賀美	カガミ	420	1920	5436816	79.4452
1921	蔭山	カゲヤマ	419	1921	5437235	79.4513
1922	本城	ホンジヨウ	419	1921	5437654	79.4575
1923	浅羽	アサバ	418	1923	5438072	79.4636
1924	桑名	クワナ	418	1923	5438490	79.4697
1925	■原	タカハラ	418	1923	5438908	79.4758
1926	広井	ヒロイ	418	1923	5439326	79.4819
1927	和久井	ワクイ	418	1923	5439744	79.488
1928	亀岡	カメオカ	417	1928	5440161	79.4941
1929	君島	キミジマ	417	1928	5440578	79.5002
1930	笹井	ササイ	417	1928	5440995	79.5063
1931	白浜	シラハマ	417	1928	5441412	79.5124
1932	宮里	ミヤザト	417	1928	5441829	79.5185
1933	黒滝	クロタキ	416	1933	5442245	79.5245
1934	雑賀	サイカ	416	1933	5442661	79.5306
1935	稲見	イナミ	415	1935	5443076	79.5367
1936	栗城	クリキ	415	1935	5443491	79.5427
1937	吉山	ヨシヤマ	415	1935	5443906	79.5488
1938	鹿野	カノ	414	1938	5444320	79.5549
1939	■崎	タカサキ	414	1938	5444734	79.5609
1940	山際	ヤマギワ	414	1938	5445148	79.567
1941	潮田	ウシオダ	413	1941	5445561	79.573
1942	丸	マル	413	1941	5445974	79.579
1943	笈川	オイカワ	412	1943	5446386	79.585
1944	木野	キノ	412	1943	5446798	79.5911
1945	作田	サクタ	412	1943	5447210	79.5971
1946	新海	シンカイ	412	1943	5447622	79.6031
1947	戸塚	トヅカ	412	1943	5448034	79.6091
1948	肥田	ヒダ	412	1943	5448446	79.6151
1949	盛	モリ	412	1943	5448858	79.6212
1950	八鍬	ヤクワ	412	1943	5449270	79.6272
1951	秋吉	アキヨシ	411	1951	5449681	79.6332
1952	折田	オリタ	411	1951	5450092	79.6392
1953	柏	カシワ	411	1951	5450503	79.6452
1954	柴野	シバノ	411	1951	5450914	79.6512
1955	杉森	スギモリ	411	1951	5451325	79.6572
1956	宮腰	ミヤコシ	411	1951	5451736	79.6632
1957	野木	ノギ	410	1957	5452146	79.6692
1958	宇賀神	ウガジン	409	1958	5452555	79.6752
1959	金城	カネシロ	409	1958	5452964	79.6812
1960	中嶋	ナカシマ	409	1958	5453373	79.6871
1961	安本	ヤスモト	409	1958	5453782	79.6931
1962	■杉	タカスギ	408	1962	5454190	79.6991
1963	大垣	オオガキ	407	1963	5454597	79.705
1964	黒坂	クロサカ	407	1963	5455004	79.711
1965	瀧本	タキモト	407	1963	5455411	79.7169
1966	戸倉	トクラ	407	1963	5455818	79.7229
1967	中園	ナカゾノ	407	1963	5456225	79.7288
1968	布川	ヌノカワ	407	1963	5456632	79.7348
1969	姫野	ヒメノ	407	1963	5457039	79.7407
1970	赤城	アカギ	406	1970	5457445	79.7466
1971	池永	イケナガ	406	1970	5457851	79.7526
1972	岩松	イワマツ	406	1970	5458257	79.7585
1973	嵯峨	サガ	406	1970	5458663	79.7644
1974	矢萩	ヤハギ	406	1970	5459069	79.7704
1975	粟野	アワノ	405	1975	5459474	79.7763
1976	蛯名	エビナ	405	1975	5459879	79.7822
1977	苅部	カリベ	405	1975	5460284	79.7881
1978	高谷	タカヤ	405	1975	5460689	79.794
1979	尾関	オゼキ	404	1979	5461093	79.8
1980	加川	カガワ	404	1979	5461497	79.8059
1981	竹沢	タケザワ	404	1979	5461901	79.8118
1982	矢代	ヤシロ	404	1979	5462305	79.8177
1983	石神	イシガミ	403	1983	5462708	79.8236
1984	伊奈	イナ	403	1983	5463111	79.8294
1985	清家	セイケ	403	1983	5463514	79.8353
1986	■久	タカク	403	1983	5463917	79.8412
1987	生井	ナマイ	403	1983	5464320	79.8471
1988	水沢	ミズサワ	403	1983	5464723	79.853
1989	若菜	ワカナ	403	1983	5465126	79.8589
1990	■尾	タカオ	402	1990	5465528	79.8648
1991	竹野	タケノ	402	1990	5465930	79.8706
1992	藤間	フジマ	402	1990	5466332	79.8765
1993	山名	ヤマナ	402	1990	5466734	79.8824
1994	坂入	サカイリ	401	1994	5467135	79.8882
1995	霜島	シモジマ	401	1994	5467536	79.8941
1996	坪内	ツボウチ	401	1994	5467937	79.9
1997	錦織	ニシキオリ	401	1994	5468338	79.9058
1998	辺見	ヘンミ	400	1998	5468738	79.9117
1999	向山	ムカイヤマ	400	1998	5469138	79.9175
2000	山内	ヤマノウチ	400	1998	5469538	79.9234
2001	石■	イシザキ	399	2001	5469937	79.9292
2002	大前	オオマエ	399	2001	5470336	79.935
2003	川尻	カワジリ	399	2001	5470735	79.9408
2004	駒形	コマガタ	399	2001	5471134	79.9467
2005	崔	サイ	399	2001	5471533	79.9525
2006	瀬野	セノ	399	2001	5471932	79.9583
2007	仲田	ナカタ	399	2001	5472331	79.9642
2008	月岡	ツキオカ	398	2008	5472729	79.97
2009	久永	ヒサナガ	398	2008	5473127	79.9758
2010	宮森	ミヤモリ	398	2008	5473525	79.9816
2011	米本	ヨネモト	398	2008	5473923	79.9874
2012	木谷	キタニ	397	2012	5474320	79.9932
2013	越野	コシノ	397	2012	5474717	79.999
2014	沢口	サワグチ	397	2012	5475114	80.0048
2015	長南	チヨウナン	397	2012	5475511	80.0106
2016	安孫子	アビコ	396	2016	5475907	80.0164
2017	倉林	クラバヤシ	396	2016	5476303	80.0222
2018	富塚	トミヅカ	396	2016	5476699	80.028
2019	伊佐	イサ	395	2019	5477094	80.0338
2020	輿石	コシイシ	395	2019	5477489	80.0395
2021	末次	スエツグ	395	2019	5477884	80.0453
2022	成沢	ナリサワ	395	2019	5478279	80.0511
2023	桃井	モモイ	394	2023	5478673	80.0568
2024	八木沢	ヤギサワ	394	2023	5479067	80.0626
2025	永吉	ナガヨシ	393	2025	5479460	80.0683
2026	牟田	ムタ	393	2025	5479853	80.0741
2027	奥井	オクイ	392	2027	5480245	80.0798
2028	外川	トガワ	392	2027	5480637	80.0855
2029	蓮沼	ハスヌマ	392	2027	5481029	80.0913
2030	福村	フクムラ	392	2027	5481421	80.097
2031	峰	ミネ	392	2027	5481813	80.1027
2032	安野	ヤスノ	392	2027	5482205	80.1085
2033	大戸	オオト	391	2033	5482596	80.1142
2034	唐澤	カラサワ	391	2033	5482987	80.1199
2035	生田目	ナマタメ	391	2033	5483378	80.1256
2036	内堀	ウチボリ	390	2036	5483768	80.1313
2037	海老名	エビナ	390	2036	5484158	80.137
2038	生沼	オイヌマ	390	2036	5484548	80.1427
2039	小瀬村	コセムラ	390	2036	5484938	80.1484
2040	笹森	ササモリ	390	2036	5485328	80.1541
2041	小田原	オダワラ	389	2041	5485717	80.1598
2042	滝川	タキカワ	389	2041	5486106	80.1655
2043	武川	タケカワ	389	2041	5486495	80.1711
2044	田野	タノ	389	2041	5486884	80.1768
2045	豊川	トヨカワ	389	2041	5487273	80.1825
2046	比留間	ヒルマ	389	2041	5487662	80.1882
2047	前沢	マエザワ	388	2047	5488050	80.1939
2048	八木橋	ヤギハシ	388	2047	5488438	80.1995
2049	岡林	オカバヤシ	387	2049	5488825	80.2052
2050	笠松	カサマツ	387	2049	5489212	80.2108
2051	吉浜	ヨシハマ	387	2049	5489599	80.2165
2052	網野	アミノ	386	2052	5489985	80.2221
2053	清川	キヨカワ	386	2052	5490371	80.2278
2054	中道	ナカミチ	386	2052	5490757	80.2334
2055	藤沼	フジヌマ	386	2052	5491143	80.2391
2056	小谷野	コヤノ	385	2056	5491528	80.2447
2057	■田	タカタ	385	2056	5491913	80.2503
2058	春木	ハルキ	385	2056	5492298	80.2559
2059	宇井	ウイ	383	2059	5492681	80.2615
2060	江村	エムラ	383	2059	5493064	80.2671
2061	折笠	オリカサ	383	2059	5493447	80.2727
2062	茅野	カヤノ	383	2059	5493830	80.2783
2063	草山	クサヤマ	383	2059	5494213	80.2839
2064	辻井	ツジイ	383	2059	5494596	80.2895
2065	冨山	トミヤマ	383	2059	5494979	80.2951
2066	■井	ヨシイ	383	2059	5495362	80.3007
2067	大浜	オオハマ	382	2067	5495744	80.3063
2068	吉良	キラ	382	2067	5496126	80.3119
2069	西郷	サイゴウ	382	2067	5496508	80.3175
2070	野坂	ノサカ	382	2067	5496890	80.323
2071	駒田	コマダ	381	2071	5497271	80.3286
2072	宮越	ミヤコシ	381	2071	5497652	80.3342
2073	江本	エモト	380	2073	5498032	80.3397
2074	勝見	カツミ	380	2073	5498412	80.3453
2075	酒巻	サカマキ	380	2073	5498792	80.3508
2076	西浦	ニシウラ	380	2073	5499172	80.3564
2077	米谷	ヨネヤ	380	2073	5499552	80.3619
2078	梅野	ウメノ	379	2078	5499931	80.3675
2079	藤間	トウマ	379	2078	5500310	80.373
2080	蜂谷	ハチヤ	379	2078	5500689	80.3785
2081	宮井	ミヤイ	379	2078	5501068	80.3841
2082	梶野	カジノ	378	2082	5501446	80.3896
2083	神野	カミノ	378	2082	5501824	80.3951
2084	具志堅	グシケン	378	2082	5502202	80.4007
2085	向後	コウゴ	378	2082	5502580	80.4062
2086	羽生	ハニユウ	378	2082	5502958	80.4117
2087	犬飼	イヌカイ	377	2087	5503335	80.4172
2088	大瀧	オオタキ	377	2087	5503712	80.4227
2089	久保木	クボキ	377	2087	5504089	80.4282
2090	小見山	コミヤマ	377	2087	5504466	80.4337
2091	笹山	ササヤマ	377	2087	5504843	80.4392
2092	水嶋	ミズシマ	377	2087	5505220	80.4448
2093	有吉	アリヨシ	376	2093	5505596	80.4503
2094	安斎	アンザイ	376	2093	5505972	80.4557
2095	瀬沼	セヌマ	376	2093	5506348	80.4612
2096	竹澤	タケザワ	376	2093	5506724	80.4667
2097	鳥井	トリイ	376	2093	5507100	80.4722
2098	西塚	ニシヅカ	376	2093	5507476	80.4777
2099	別所	ベツシヨ	376	2093	5507852	80.4832
2100	李	リ−	376	2093	5508228	80.4887
2101	越後	エチゴ	375	2101	5508603	80.4942
2102	興津	オキツ	375	2101	5508978	80.4997
2103	高宮	タカミヤ	375	2101	5509353	80.5051
2104	橋場	ハシバ	375	2101	5509728	80.5106
2105	日置	ヒオキ	375	2101	5510103	80.5161
2106	早乙女	サオトメ	374	2106	5510477	80.5216
2107	下平	シモダイラ	374	2106	5510851	80.527
2108	高石	タカイシ	374	2106	5511225	80.5325
2109	■見	タカミ	374	2106	5511599	80.538
2110	橋田	ハシダ	374	2106	5511973	80.5434
2111	荒田	アラタ	373	2111	5512346	80.5489
2112	白戸	シラト	373	2111	5512719	80.5543
2113	■城	タカギ	373	2111	5513092	80.5598
2114	西嶋	ニシジマ	373	2111	5513465	80.5652
2115	■田	ハマダ	373	2111	5513838	80.5707
2116	東	アヅマ	372	2116	5514210	80.5761
2117	荒巻	アラマキ	372	2116	5514582	80.5816
2118	田仲	タナカ	372	2116	5514954	80.587
2119	谷藤	タニフジ	372	2116	5515326	80.5924
2120	趙	チヨウ	372	2116	5515698	80.5979
2121	赤津	アカツ	371	2121	5516069	80.6033
2122	荒谷	アラヤ	371	2121	5516440	80.6087
2123	瀧	タキ	371	2121	5516811	80.6141
2124	寺嶋	テラシマ	371	2121	5517182	80.6196
2125	堀部	ホリベ	371	2121	5517553	80.625
2126	簑島	ミノシマ	371	2121	5517924	80.6304
2127	植竹	ウエタケ	370	2127	5518294	80.6358
2128	轟	トドロキ	370	2127	5518664	80.6412
2129	羽山	ハヤマ	370	2127	5519034	80.6466
2130	番場	バンバ	370	2127	5519404	80.652
2131	池原	イケハラ	369	2131	5519773	80.6574
2132	岡元	オカモト	369	2131	5520142	80.6628
2133	川北	カワキタ	369	2131	5520511	80.6682
2134	坂内	サカウチ	369	2131	5520880	80.6736
2135	白土	シラト	369	2131	5521249	80.679
2136	山西	ヤマニシ	369	2131	5521618	80.6844
2137	池	イケ	368	2137	5521986	80.6897
2138	泉田	イズミダ	368	2137	5522354	80.6951
2139	上山	ウエヤマ	368	2137	5522722	80.7005
2140	大月	オオツキ	368	2137	5523090	80.7059
2141	片田	カタダ	368	2137	5523458	80.7113
2142	近野	コンノ	368	2137	5523826	80.7166
2143	杉谷	スギタニ	368	2137	5524194	80.722
2144	高木	タカキ	368	2137	5524562	80.7274
2145	高桑	タカクワ	368	2137	5524930	80.7328
2146	田巻	タマキ	368	2137	5525298	80.7381
2147	油井	ユイ	368	2137	5525666	80.7435
2148	徐	ジヨ	367	2148	5526033	80.7489
2149	永沢	ナガサワ	367	2148	5526400	80.7542
2150	島■	シマザキ	366	2150	5526766	80.7596
2151	嶋津	シマヅ	366	2150	5527132	80.7649
2152	宮治	ミヤジ	366	2150	5527498	80.7703
2153	吉松	ヨシマツ	366	2150	5527864	80.7756
2154	鏑木	カブラギ	365	2154	5528229	80.781
2155	花輪	ハナワ	365	2154	5528594	80.7863
2156	郷	ゴウ	364	2156	5528958	80.7916
2157	船田	フナダ	364	2156	5529322	80.7969
2158	宮岡	ミヤオカ	364	2156	5529686	80.8023
2159	漆原	ウルシハラ	363	2159	5530049	80.8076
2160	大脇	オオワキ	363	2159	5530412	80.8129
2161	柏倉	カシワクラ	363	2159	5530775	80.8182
2162	古川	コガワ	363	2159	5531138	80.8235
2163	野瀬	ノセ	363	2159	5531501	80.8288
2164	濱口	ハマグチ	363	2159	5531864	80.8341
2165	諸岡	モロオカ	363	2159	5532227	80.8394
2166	阿藤	アトウ	362	2166	5532589	80.8447
2167	井戸	イド	362	2166	5532951	80.85
2168	木元	キモト	362	2166	5533313	80.8553
2169	信田	ノブタ	362	2166	5533675	80.8606
2170	野元	ノモト	362	2166	5534037	80.8658
2171	宮代	ミヤダイ	362	2166	5534399	80.8711
2172	田野井	タノイ	361	2172	5534760	80.8764
2173	山越	ヤマコシ	361	2172	5535121	80.8817
2174	吉江	ヨシエ	361	2172	5535482	80.887
2175	垣内	カキウチ	360	2175	5535842	80.8922
2176	坂部	サカベ	360	2175	5536202	80.8975
2177	彦坂	ヒコサカ	360	2175	5536562	80.9027
2178	榎田	エノキダ	359	2178	5536921	80.908
2179	奥平	オクダイラ	359	2178	5537280	80.9132
2180	尾山	オヤマ	359	2178	5537639	80.9185
2181	藤	フジ	359	2178	5537998	80.9237
2182	古内	フルウチ	359	2178	5538357	80.929
2183	古家	フルヤ	359	2178	5538716	80.9342
2184	入内島	イリウチジマ	358	2184	5539074	80.9394
2185	土門	ドモン	358	2184	5539432	80.9447
2186	新沼	ニイヌマ	358	2184	5539790	80.9499
2187	堀尾	ホリオ	358	2184	5540148	80.9551
2188	脇本	ワキモト	358	2184	5540506	80.9604
2189	芥川	アクタガワ	357	2189	5540863	80.9656
2190	小尾	オビ	357	2189	5541220	80.9708
2191	勝	カツ	357	2189	5541577	80.976
2192	君塚	キミヅカ	357	2189	5541934	80.9812
2193	倉沢	クラサワ	357	2189	5542291	80.9865
2194	中居	ナカイ	357	2189	5542648	80.9917
2195	萩生田	ハギウダ	357	2189	5543005	80.9969
2196	廣澤	ヒロサワ	357	2189	5543362	81.0021
2197	郭	カク	356	2197	5543718	81.0073
2198	甲田	コウダ	356	2197	5544074	81.0125
2199	土肥	ドイ	356	2197	5544430	81.0177
2200	盛田	モリタ	356	2197	5544786	81.0229
2201	赤嶺	アカミネ	355	2201	5545141	81.0281
2202	周	シユウ	355	2201	5545496	81.0333
2203	清	セイ	355	2201	5545851	81.0385
2204	曽我部	ソガベ	355	2201	5546206	81.0437
2205	樋渡	ヒワタシ	355	2201	5546561	81.0488
2206	横瀬	ヨコセ	355	2201	5546916	81.054
2207	熊切	クマキリ	354	2207	5547270	81.0592
2208	竹谷	タケヤ	354	2207	5547624	81.0644
2209	永原	ナガハラ	354	2207	5547978	81.0696
2210	荒牧	アラマキ	353	2210	5548331	81.0747
2211	上地	ウエチ	353	2210	5548684	81.0799
2212	景山	カゲヤマ	353	2210	5549037	81.085
2213	小板橋	コイタバシ	353	2210	5549390	81.0902
2214	高	コウ	353	2210	5549743	81.0953
2215	鶴巻	ツルマキ	353	2210	5550096	81.1005
2216	深町	フカマチ	353	2210	5550449	81.1057
2217	三国	ミクニ	353	2210	5550802	81.1108
2218	大金	オオガネ	352	2218	5551154	81.116
2219	大須賀	オオスカ	352	2218	5551506	81.1211
2220	渋沢	シブサワ	352	2218	5551858	81.1263
2221	戸沢	トザワ	352	2218	5552210	81.1314
2222	芦澤	アシザワ	351	2222	5552561	81.1365
2223	樫村	カシムラ	351	2222	5552912	81.1417
2224	川手	カワテ	351	2222	5553263	81.1468
2225	木藤	キトウ	351	2222	5553614	81.1519
2226	松江	マツエ	351	2222	5553965	81.157
2227	木山	キヤマ	350	2227	5554315	81.1622
2228	細矢	ホソヤ	350	2227	5554665	81.1673
2229	飯泉	イイズミ	349	2229	5555014	81.1724
2230	掛川	カケガワ	349	2229	5555363	81.1775
2231	梶ケ谷	カジガヤ	349	2229	5555712	81.1826
2232	杉沢	スギサワ	349	2229	5556061	81.1877
2233	中屋	ナカヤ	349	2229	5556410	81.1928
2234	長橋	ナガハシ	349	2229	5556759	81.1979
2235	波田野	ハタノ	349	2229	5557108	81.203
2236	柳谷	ヤナギヤ	349	2229	5557457	81.2081
2237	三枝	サイグサ	348	2237	5557805	81.2132
2238	戸谷	トヤ	348	2237	5558153	81.2182
2239	仲	ナカ	348	2237	5558501	81.2233
2240	真島	マジマ	348	2237	5558849	81.2284
2241	峯村	ミネムラ	348	2237	5559197	81.2335
2242	大畠	オオハタ	347	2242	5559544	81.2386
2243	押切	オシキリ	347	2242	5559891	81.2436
2244	小橋	コバシ	347	2242	5560238	81.2487
2245	白田	シラタ	347	2242	5560585	81.2538
2246	湯澤	ユザワ	347	2242	5560932	81.2588
2247	■本	ヨシモト	347	2242	5561279	81.2639
2248	毛塚	ケヅカ	346	2248	5561625	81.269
2249	白崎	シラサキ	346	2248	5561971	81.274
2250	杉江	スギエ	346	2248	5562317	81.2791
2251	海老澤	エビサワ	345	2251	5562662	81.2841
2252	国本	クニモト	345	2251	5563007	81.2892
2253	仲山	ナカヤマ	345	2251	5563352	81.2942
2254	水澤	ミズサワ	345	2251	5563697	81.2992
2255	中鉢	チユウバチ	344	2255	5564041	81.3043
2256	津川	ツガワ	344	2255	5564385	81.3093
2257	久田	ヒサダ	344	2255	5564729	81.3143
2258	水沼	ミズヌマ	344	2255	5565073	81.3194
2259	宮部	ミヤベ	344	2255	5565417	81.3244
2260	和知	ワチ	344	2255	5565761	81.3294
2261	磯辺	イソベ	343	2261	5566104	81.3344
2262	高坂	コウサカ	343	2261	5566447	81.3394
2263	古山	コヤマ	343	2261	5566790	81.3444
2264	安江	ヤスエ	343	2261	5567133	81.3495
2265	蓬田	ヨモギダ	343	2261	5567476	81.3545
2266	城間	シロマ	342	2266	5567818	81.3595
2267	田部	タベ	342	2266	5568160	81.3645
2268	豊岡	トヨオカ	342	2266	5568502	81.3695
2269	古矢	フルヤ	342	2266	5568844	81.3745
2270	宮武	ミヤタケ	342	2266	5569186	81.3795
2271	山上	ヤマカミ	342	2266	5569528	81.3845
2272	小滝	コタキ	341	2272	5569869	81.3894
2273	設楽	シタラ	341	2272	5570210	81.3944
2274	芝崎	シバザキ	341	2272	5570551	81.3994
2275	霜田	シモダ	341	2272	5570892	81.4044
2276	永澤	ナガサワ	341	2272	5571233	81.4094
2277	野地	ノヂ	341	2272	5571574	81.4144
2278	松枝	マツエダ	341	2272	5571915	81.4193
2279	横須賀	ヨコスカ	341	2272	5572256	81.4243
2280	熱田	アツタ	340	2280	5572596	81.4293
2281	大町	オオマチ	340	2280	5572936	81.4343
2282	河辺	カワベ	340	2280	5573276	81.4392
2283	戸澤	トザワ	340	2280	5573616	81.4442
2284	友井	トモイ	340	2280	5573956	81.4492
2285	長峰	ナガミネ	340	2280	5574296	81.4541
2286	堀野	ホリノ	340	2280	5574636	81.4591
2287	牧島	マキシマ	340	2280	5574976	81.4641
2288	芹田	セリタ	339	2288	5575315	81.469
2289	知久	チク	339	2288	5575654	81.474
2290	増島	マスジマ	339	2288	5575993	81.4789
2291	三嶋	ミシマ	339	2288	5576332	81.4839
2292	森村	モリムラ	339	2288	5576671	81.4888
2293	秋野	アキノ	338	2293	5577009	81.4938
2294	中平	ナカヒラ	338	2293	5577347	81.4987
2295	榎	エノキ	337	2295	5577684	81.5036
2296	栄	サカエ	337	2295	5578021	81.5086
2297	佐々	ササ	337	2295	5578358	81.5135
2298	笹島	ササジマ	337	2295	5578695	81.5184
2299	新津	ニイツ	337	2295	5579032	81.5233
2300	花村	ハナムラ	337	2295	5579369	81.5283
2301	浅香	アサカ	336	2301	5579705	81.5332
2302	瀬下	セシモ	336	2301	5580041	81.5381
2303	安池	ヤスイケ	336	2301	5580377	81.543
2304	坂内	バンナイ	335	2304	5580712	81.5479
2305	鵜沢	ウザワ	334	2305	5581046	81.5528
2306	香月	カツキ	334	2305	5581380	81.5576
2307	勝間田	カツマタ	334	2305	5581714	81.5625
2308	下條	シモジヨウ	334	2305	5582048	81.5674
2309	寺川	テラカワ	334	2305	5582382	81.5723
2310	中込	ナカゴミ	334	2305	5582716	81.5772
2311	三嶽	ミタケ	334	2305	5583050	81.582
2312	江澤	エザワ	333	2312	5583383	81.5869
2313	中瀬	ナカセ	333	2312	5583716	81.5918
2314	松谷	マツヤ	333	2312	5584049	81.5966
2315	皆川	ミナカワ	333	2312	5584382	81.6015
2316	横倉	ヨコクラ	333	2312	5584715	81.6064
2317	有坂	アリサカ	332	2317	5585047	81.6112
2318	鏡	カガミ	332	2317	5585379	81.6161
2319	勝野	カツノ	332	2317	5585711	81.6209
2320	木部	キベ	332	2317	5586043	81.6258
2321	白根	シラネ	332	2317	5586375	81.6306
2322	田井	タイ	332	2317	5586707	81.6355
2323	大門	ダイモン	332	2317	5587039	81.6403
2324	本木	モトキ	332	2317	5587371	81.6452
2325	山科	ヤマシナ	332	2317	5587703	81.65
2326	雨宮	アマミヤ	331	2326	5588034	81.6549
2327	江島	エジマ	331	2326	5588365	81.6597
2328	宗	ソウ	331	2326	5588696	81.6645
2329	南波	ナンバ	331	2326	5589027	81.6694
2330	茂呂	モロ	331	2326	5589358	81.6742
2331	孫	ソン	330	2331	5589688	81.679
2332	樋山	ヒヤマ	330	2331	5590018	81.6839
2333	松丸	マツマル	330	2331	5590348	81.6887
2334	鮫島	サメシマ	329	2334	5590677	81.6935
2335	末松	スエマツ	329	2334	5591006	81.6983
2336	横沢	ヨコザワ	329	2334	5591335	81.7031
2337	正田	シヨウダ	328	2337	5591663	81.7079
2338	利根川	トネガワ	328	2337	5591991	81.7127
2339	滑川	ナメカワ	328	2337	5592319	81.7175
2340	宮木	ミヤキ	328	2337	5592647	81.7223
2341	浦島	ウラシマ	327	2341	5592974	81.7271
2342	徳丸	トクマル	327	2341	5593301	81.7318
2343	渡井	ワタイ	327	2341	5593628	81.7366
2344	片柳	カタヤナギ	326	2344	5593954	81.7414
2345	鴨下	カモシタ	326	2344	5594280	81.7461
2346	草刈	クサカリ	326	2344	5594606	81.7509
2347	重野	シゲノ	326	2344	5594932	81.7557
2348	梶谷	カジタニ	325	2348	5595257	81.7604
2349	剣持	ケンモチ	325	2348	5595582	81.7652
2350	玉置	タマキ	325	2348	5595907	81.7699
2351	能條	ノウジヨウ	325	2348	5596232	81.7747
2352	朴	ボク	325	2348	5596557	81.7794
2353	安彦	アビコ	324	2353	5596881	81.7841
2354	小関	オゼキ	324	2353	5597205	81.7889
2355	小向	コムカイ	324	2353	5597529	81.7936
2356	武富	タケトミ	324	2353	5597853	81.7984
2357	辻田	ツジタ	324	2353	5598177	81.8031
2358	濱	ハマ	324	2353	5598501	81.8078
2359	桐ケ谷	キリガヤ	323	2359	5598824	81.8125
2360	戸張	トバリ	323	2359	5599147	81.8173
2361	中橋	ナカハシ	323	2359	5599470	81.822
2362	檜山	ヒヤマ	323	2359	5599793	81.8267
2363	宮口	ミヤグチ	323	2359	5600116	81.8314
2364	森住	モリズミ	323	2359	5600439	81.8361
2365	浅尾	アサオ	322	2365	5600761	81.8408
2366	市田	イチダ	322	2365	5601083	81.8455
2367	江原	エバラ	322	2365	5601405	81.8503
2368	権田	ゴンダ	322	2365	5601727	81.855
2369	下島	シモジマ	322	2365	5602049	81.8597
2370	■林	タカバヤシ	322	2365	5602371	81.8644
2371	赤羽	アカハネ	321	2371	5602692	81.8691
2372	小■	コダカ	321	2371	5603013	81.8738
2373	西海	ニシウミ	321	2371	5603334	81.8784
2374	浜村	ハマムラ	321	2371	5603655	81.8831
2375	泉谷	イズミヤ	320	2375	5603975	81.8878
2376	岩尾	イワオ	320	2375	5604295	81.8925
2377	岩波	イワナミ	320	2375	5604615	81.8972
2378	岩山	イワヤマ	320	2375	5604935	81.9018
2379	清宮	キヨミヤ	320	2375	5605255	81.9065
2380	櫻田	サクラダ	320	2375	5605575	81.9112
2381	反町	ソリマチ	320	2375	5605895	81.9159
2382	種市	タネイチ	320	2375	5606215	81.9205
2383	對馬	ツシマ	320	2375	5606535	81.9252
2384	寺村	テラムラ	320	2375	5606855	81.9299
2385	中畑	ナカハタ	320	2375	5607175	81.9346
2386	日原	ヒハラ	320	2375	5607495	81.9392
2387	牛田	ウシダ	319	2387	5607814	81.9439
2388	木崎	キザキ	319	2387	5608133	81.9486
2389	新垣	シンガキ	319	2387	5608452	81.9532
2390	淡路	アワジ	318	2390	5608770	81.9579
2391	小河	オガワ	318	2390	5609088	81.9625
2392	脇坂	ワキサカ	318	2390	5609406	81.9672
2393	尾田	オダ	317	2393	5609723	81.9718
2394	中條	チユウジヨウ	317	2393	5610040	81.9764
2395	新谷	シンヤ	316	2395	5610356	81.9811
2396	立原	タチハラ	316	2395	5610672	81.9857
2397	長久保	ナガクボ	316	2395	5610988	81.9903
2398	原山	ハラヤマ	316	2395	5611304	81.9949
2399	横手	ヨコテ	316	2395	5611620	81.9995
2400	神山	コウヤマ	315	2400	5611935	82.0041
2401	仲間	ナカマ	315	2400	5612250	82.0087
2402	永尾	ナガオ	315	2400	5612565	82.0133
2403	梨本	ナシモト	315	2400	5612880	82.0179
2404	三品	ミシナ	315	2400	5613195	82.0225
2405	新妻	ニイヅマ	314	2405	5613509	82.0271
2406	西出	ニシデ	314	2405	5613823	82.0317
2407	沼尻	ヌマジリ	314	2405	5614137	82.0363
2408	芳野	ヨシノ	314	2405	5614451	82.0409
2409	有本	アリモト	313	2409	5614764	82.0455
2410	佐田	サダ	313	2409	5615077	82.05
2411	武居	タケイ	313	2409	5615390	82.0546
2412	立山	タテヤマ	313	2409	5615703	82.0592
2413	餅田	モチダ	313	2409	5616016	82.0638
2414	菊島	キクシマ	312	2414	5616328	82.0683
2415	鍛代	キタイ	312	2414	5616640	82.0729
2416	佐宗	サソウ	312	2414	5616952	82.0774
2417	永沼	ナガヌマ	312	2414	5617264	82.082
2418	山辺	ヤマベ	312	2414	5617576	82.0866
2419	植原	ウエハラ	311	2419	5617887	82.0911
2420	大塩	オオシオ	311	2419	5618198	82.0956
2421	勝部	カツベ	311	2419	5618509	82.1002
2422	勝呂	スグロ	311	2419	5618820	82.1047
2423	星崎	ホシザキ	311	2419	5619131	82.1093
2424	真木	マキ	311	2419	5619442	82.1138
2425	天田	アマダ	310	2425	5619752	82.1183
2426	飯倉	イイクラ	310	2425	5620062	82.1229
2427	片寄	カタヨセ	310	2425	5620372	82.1274
2428	佐賀	サガ	310	2425	5620682	82.1319
2429	渋川	シブカワ	310	2425	5620992	82.1365
2430	辻野	ツジノ	310	2425	5621302	82.141
2431	飯岡	イイオカ	309	2431	5621611	82.1455
2432	飯森	イイモリ	309	2431	5621920	82.15
2433	今津	イマヅ	309	2431	5622229	82.1545
2434	宇津木	ウツギ	309	2431	5622538	82.1591
2435	大室	オオムロ	309	2431	5622847	82.1636
2436	嶋■	シマザキ	309	2431	5623156	82.1681
2437	前場	ゼンバ	309	2431	5623465	82.1726
2438	豊嶋	トヨシマ	309	2431	5623774	82.1771
2439	樋川	ヒカワ	309	2431	5624083	82.1816
2440	山賀	ヤマガ	309	2431	5624392	82.1862
2441	我妻	アガツマ	308	2441	5624700	82.1907
2442	井草	イグサ	308	2441	5625008	82.1952
2443	大窪	オオクボ	308	2441	5625316	82.1997
2444	新屋	シンヤ	308	2441	5625624	82.2042
2445	岩谷	イワタニ	307	2445	5625931	82.2086
2446	神村	カミムラ	307	2445	5626238	82.2131
2447	楠田	クスダ	307	2445	5626545	82.2176
2448	竹永	タケナガ	307	2445	5626852	82.2221
2449	野谷	ノヤ	307	2445	5627159	82.2266
2450	朴	パク	307	2445	5627466	82.2311
2451	山添	ヤマゾエ	307	2445	5627773	82.2356
2452	安齋	アンザイ	306	2452	5628079	82.24
2453	大本	オオモト	306	2452	5628385	82.2445
2454	中元	ナカモト	306	2452	5628691	82.249
2455	増尾	マスオ	306	2452	5628997	82.2534
2456	増川	マスカワ	306	2452	5629303	82.2579
2457	三堀	ミツホリ	306	2452	5629609	82.2624
2458	川澄	カワスミ	305	2458	5629914	82.2668
2459	五木田	ゴキタ	305	2458	5630219	82.2713
2460	細貝	ホソガイ	305	2458	5630524	82.2758
2461	松波	マツナミ	305	2458	5630829	82.2802
2462	岩川	イワカワ	304	2462	5631133	82.2847
2463	新村	シンムラ	304	2462	5631437	82.2891
2464	種村	タネムラ	304	2462	5631741	82.2935
2465	千原	チハラ	304	2462	5632045	82.298
2466	登坂	トサカ	304	2462	5632349	82.3024
2467	堀池	ホリイケ	304	2462	5632653	82.3069
2468	水木	ミズキ	304	2462	5632957	82.3113
2469	米原	ヨネハラ	304	2462	5633261	82.3157
2470	木幡	コハタ	303	2470	5633564	82.3202
2471	三森	ミツモリ	303	2470	5633867	82.3246
2472	脇山	ワキヤマ	303	2470	5634170	82.329
2473	大口	オオグチ	302	2473	5634472	82.3334
2474	金木	カネキ	302	2473	5634774	82.3379
2475	栢沼	カヤヌマ	302	2473	5635076	82.3423
2476	杉井	スギイ	302	2473	5635378	82.3467
2477	砂川	スナカワ	302	2473	5635680	82.3511
2478	■津	タカツ	302	2473	5635982	82.3555
2479	谷岡	タニオカ	302	2473	5636284	82.3599
2480	二ノ宮	ニノミヤ	302	2473	5636586	82.3643
2481	谷津	ヤツ	302	2473	5636888	82.3687
2482	小野里	オノザト	301	2482	5637189	82.3731
2483	瀧口	タキグチ	301	2482	5637490	82.3775
2484	仲本	ナカモト	301	2482	5637791	82.3819
2485	伊賀	イガ	300	2485	5638091	82.3863
2486	柿澤	カキザワ	300	2485	5638391	82.3907
2487	加来	カク	300	2485	5638691	82.3951
2488	三枝木	サエキ	300	2485	5638991	82.3995
2489	巴	トモエ	300	2485	5639291	82.4039
2490	弓削	ユゲ	300	2485	5639591	82.4082
2491	新谷	アラヤ	299	2491	5639890	82.4126
2492	植草	ウエクサ	299	2491	5640189	82.417
2493	上林	カンバヤシ	299	2491	5640488	82.4214
2494	竹花	タケハナ	299	2491	5640787	82.4257
2495	桑島	クワジマ	298	2495	5641085	82.4301
2496	舟木	フナキ	298	2495	5641383	82.4344
2497	堀切	ホリキリ	298	2495	5641681	82.4388
2498	屋代	ヤシロ	298	2495	5641979	82.4431
2499	有賀	アルガ	297	2499	5642276	82.4475
2500	大胡	オオゴ	297	2499	5642573	82.4518
2501	兼平	カネヒラ	297	2499	5642870	82.4562
2502	郡山	コオリヤマ	297	2499	5643167	82.4605
2503	杉	スギ	297	2499	5643464	82.4648
2504	鶴井	ツルイ	297	2499	5643761	82.4692
2505	金原	キンバラ	296	2505	5644057	82.4735
2506	津野	ツノ	296	2505	5644353	82.4778
2507	浜岡	ハマオカ	296	2505	5644649	82.4822
2508	菱山	ヒシヤマ	296	2505	5644945	82.4865
2509	向田	ムカイダ	296	2505	5645241	82.4908
2510	大■	オオサキ	295	2510	5645536	82.4951
2511	沖津	オキツ	295	2510	5645831	82.4994
2512	貝瀬	カイセ	295	2510	5646126	82.5037
2513	渋谷	シブタニ	295	2510	5646421	82.508
2514	遠山	トウヤマ	295	2510	5646716	82.5124
2515	西谷	ニシヤ	295	2510	5647011	82.5167
2516	浅原	アサハラ	294	2516	5647305	82.521
2517	宇都	ウト	294	2516	5647599	82.5253
2518	釼持	ケンモツ	294	2516	5647893	82.5296
2519	阪口	サカグチ	294	2516	5648187	82.5339
2520	笹	ササ	294	2516	5648481	82.5382
2521	沢	サワ	294	2516	5648775	82.5424
2522	中江	ナカエ	294	2516	5649069	82.5467
2523	猿田	サルタ	293	2523	5649362	82.551
2524	武部	タケベ	293	2523	5649655	82.5553
2525	藤谷	フジヤ	293	2523	5649948	82.5596
2526	河島	カワシマ	292	2526	5650240	82.5639
2527	武村	タケムラ	292	2526	5650532	82.5681
2528	丹沢	タンザワ	292	2526	5650824	82.5724
2529	成澤	ナリサワ	292	2526	5651116	82.5767
2530	庭野	ニワノ	292	2526	5651408	82.5809
2531	藤波	フジナミ	292	2526	5651700	82.5852
2532	黛	マユズミ	292	2526	5651992	82.5895
2533	小木曽	オギソ	291	2533	5652283	82.5937
2534	小島	オジマ	291	2533	5652574	82.598
2535	海藤	カイトウ	291	2533	5652865	82.6022
2536	坂根	サカネ	291	2533	5653156	82.6065
2537	田岡	タオカ	291	2533	5653447	82.6107
2538	野々村	ノノムラ	291	2533	5653738	82.615
2539	東田	ヒガシダ	291	2533	5654029	82.6192
2540	古野	フルノ	291	2533	5654320	82.6235
2541	溝田	ミゾタ	291	2533	5654611	82.6277
2542	安村	ヤスムラ	291	2533	5654902	82.632
2543	会沢	アイザワ	290	2543	5655192	82.6362
2544	赤沢	アカザワ	290	2543	5655482	82.6405
2545	栗栖	クリス	290	2543	5655772	82.6447
2546	新川	ニツカワ	290	2543	5656062	82.6489
2547	広岡	ヒロオカ	290	2543	5656352	82.6532
2548	前澤	マエザワ	290	2543	5656642	82.6574
2549	大舘	オオダテ	289	2549	5656931	82.6616
2550	香山	カヤマ	289	2549	5657220	82.6658
2551	管野	カンノ	289	2549	5657509	82.6701
2552	北本	キタモト	289	2549	5657798	82.6743
2553	輿水	コシミズ	289	2549	5658087	82.6785
2554	駒場	コマバ	289	2549	5658376	82.6827
2555	瀬田	セタ	289	2549	5658665	82.687
2556	■■	タカサキ	289	2549	5658954	82.6912
2557	芦野	アシノ	288	2557	5659242	82.6954
2558	川畑	カワハタ	288	2557	5659530	82.6996
2559	喜多村	キタムラ	288	2557	5659818	82.7038
2560	白幡	シラハタ	288	2557	5660106	82.708
2561	安武	ヤスタケ	288	2557	5660394	82.7122
2562	磯■	イソザキ	287	2562	5660681	82.7164
2563	浮田	ウキタ	287	2562	5660968	82.7206
2564	郷原	ゴウハラ	287	2562	5661255	82.7248
2565	設楽	シダラ	287	2562	5661542	82.729
2566	十文字	ジユウモンジ	287	2562	5661829	82.7332
2567	長江	ナガエ	287	2562	5662116	82.7374
2568	新島	ニイジマ	287	2562	5662403	82.7416
2569	西内	ニシウチ	287	2562	5662690	82.7458
2570	道下	ミチシタ	287	2562	5662977	82.75
2571	茨木	イバラキ	286	2571	5663263	82.7542
2572	今岡	イマオカ	286	2571	5663549	82.7583
2573	岩上	イワカミ	286	2571	5663835	82.7625
2574	剱持	ケンモチ	286	2571	5664121	82.7667
2575	越田	コシダ	286	2571	5664407	82.7709
2576	高本	タカモト	286	2571	5664693	82.775
2577	名和	ナワ	286	2571	5664979	82.7792
2578	仁木	ニキ	286	2571	5665265	82.7834
2579	堀米	ホリゴメ	286	2571	5665551	82.7876
2580	矢田	ヤタ	286	2571	5665837	82.7918
2581	綿引	ワタヒキ	286	2571	5666123	82.7959
2582	赤澤	アカザワ	285	2582	5666408	82.8001
2583	宇佐見	ウサミ	285	2582	5666693	82.8043
2584	近江	オウミ	285	2582	5666978	82.8084
2585	押尾	オシオ	285	2582	5667263	82.8126
2586	片瀬	カタセ	285	2582	5667548	82.8168
2587	金指	カナザシ	285	2582	5667833	82.8209
2588	篠	シノ	285	2582	5668118	82.8251
2589	武本	タケモト	285	2582	5668403	82.8293
2590	丹下	タンゲ	285	2582	5668688	82.8334
2591	仁藤	ニトウ	285	2582	5668973	82.8376
2592	三石	ミツイシ	285	2582	5669258	82.8418
2593	柳生	ヤギユウ	285	2582	5669543	82.8459
2594	井桁	イゲタ	284	2594	5669827	82.8501
2595	糸賀	イトガ	284	2594	5670111	82.8542
2596	江森	エモリ	284	2594	5670395	82.8584
2597	大川原	オオカワラ	284	2594	5670679	82.8625
2598	塩島	シオジマ	284	2594	5670963	82.8667
2599	島津	シマズ	284	2594	5671247	82.8708
2600	鍋田	ナベタ	284	2594	5671531	82.875
2601	岩原	イワハラ	283	2601	5671814	82.8791
2602	唐戸	カラト	283	2601	5672097	82.8832
2603	小湊	コミナト	283	2601	5672380	82.8874
2604	徳増	トクマス	283	2601	5672663	82.8915
2605	西垣	ニシガキ	283	2601	5672946	82.8956
2606	福留	フクドメ	283	2601	5673229	82.8998
2607	右田	ミギタ	283	2601	5673512	82.9039
2608	若生	ワコウ	283	2601	5673795	82.9081
2609	渡瀬	ワタセ	283	2601	5674078	82.9122
2610	李	イ	282	2610	5674360	82.9163
2611	金川	カナガワ	282	2610	5674642	82.9204
2612	笹生	サソウ	282	2610	5674924	82.9245
2613	■塚	タカツカ	282	2610	5675206	82.9287
2614	種田	タネダ	282	2610	5675488	82.9328
2615	中津	ナカツ	282	2610	5675770	82.9369
2616	福崎	フクザキ	282	2610	5676052	82.941
2617	増沢	マスザワ	282	2610	5676334	82.9452
2618	市毛	イチゲ	281	2618	5676615	82.9493
2619	小野崎	オノザキ	281	2618	5676896	82.9534
2620	末木	スエキ	281	2618	5677177	82.9575
2621	玉村	タマムラ	281	2618	5677458	82.9616
2622	山地	ヤマジ	281	2618	5677739	82.9657
2623	井山	イヤマ	280	2623	5678019	82.9698
2624	荻窪	オギクボ	280	2623	5678299	82.9739
2625	勝亦	カツマタ	280	2623	5678579	82.978
2626	金光	カネミツ	280	2623	5678859	82.982
2627	四宮	シノミヤ	280	2623	5679139	82.9861
2628	新里	シンザト	280	2623	5679419	82.9902
2629	仁平	ニヘイ	280	2623	5679699	82.9943
2630	廣井	ヒロイ	280	2623	5679979	82.9984
2631	和智	ワチ	280	2623	5680259	83.0025
2632	兼田	カネダ	279	2632	5680538	83.0066
2633	金原	カネハラ	279	2632	5680817	83.0107
2634	長屋	ナガヤ	279	2632	5681096	83.0147
2635	會田	アイダ	278	2635	5681374	83.0188
2636	我妻	アヅマ	278	2635	5681652	83.0229
2637	昆	コン	278	2635	5681930	83.0269
2638	五月女	サオトメ	278	2635	5682208	83.031
2639	嵯峨野	サガノ	278	2635	5682486	83.035
2640	志澤	シザワ	278	2635	5682764	83.0391
2641	七海	ナナウミ	278	2635	5683042	83.0432
2642	松藤	マツフジ	278	2635	5683320	83.0472
2643	松宮	マツミヤ	278	2635	5683598	83.0513
2644	塩入	シオイリ	277	2644	5683875	83.0553
2645	本宮	モトミヤ	277	2644	5684152	83.0594
2646	尾野	オノ	276	2646	5684428	83.0634
2647	河内	コウチ	276	2646	5684704	83.0675
2648	藤■	フジサキ	276	2646	5684980	83.0715
2649	池亀	イケガメ	275	2649	5685255	83.0755
2650	伊従	イヨリ	275	2649	5685530	83.0795
2651	大角	オオスミ	275	2649	5685805	83.0835
2652	七尾	ナナオ	275	2649	5686080	83.0876
2653	廣木	ヒロキ	275	2649	5686355	83.0916
2654	福寿	フクジユ	275	2649	5686630	83.0956
2655	谷中	ヤナカ	275	2649	5686905	83.0996
2656	阿南	アナン	274	2656	5687179	83.1036
2657	神宮	ジングウ	274	2656	5687453	83.1076
2658	藤嶋	フジシマ	274	2656	5687727	83.1116
2659	溝呂木	ミゾロギ	274	2656	5688001	83.1156
2660	安里	アサト	273	2660	5688274	83.1196
2661	池沢	イケザワ	273	2660	5688547	83.1236
2662	上松	ウエマツ	273	2660	5688820	83.1276
2663	大平	オオダイラ	273	2660	5689093	83.1316
2664	小野澤	オノザワ	273	2660	5689366	83.1356
2665	北爪	キタヅメ	273	2660	5689639	83.1396
2666	田谷	タヤ	273	2660	5689912	83.1436
2667	蛭川	ヒルカワ	273	2660	5690185	83.1475
2668	馬渡	マワタリ	273	2660	5690458	83.1515
2669	森木	モリキ	273	2660	5690731	83.1555
2670	箭内	ヤナイ	273	2660	5691004	83.1595
2671	和賀	ワガ	273	2660	5691277	83.1635
2672	小糸	コイト	272	2672	5691549	83.1675
2673	迫	サコ	272	2672	5691821	83.1715
2674	椎橋	シイバシ	272	2672	5692093	83.1754
2675	辰巳	タツミ	272	2672	5692365	83.1794
2676	新美	ニイミ	272	2672	5692637	83.1834
2677	藤城	フジシロ	272	2672	5692909	83.1874
2678	吉住	ヨシズミ	272	2672	5693181	83.1913
2679	大柳	オオヤナギ	271	2679	5693452	83.1953
2680	北浦	キタウラ	271	2679	5693723	83.1992
2681	小石	コイシ	271	2679	5693994	83.2032
2682	小南	コミナミ	271	2679	5694265	83.2072
2683	新宮	シングウ	271	2679	5694536	83.2111
2684	須川	スガワ	271	2679	5694807	83.2151
2685	冨澤	トミザワ	271	2679	5695078	83.219
2686	日向	ヒユウガ	271	2679	5695349	83.223
2687	三河	ミカワ	271	2679	5695620	83.227
2688	横浜	ヨコハマ	271	2679	5695891	83.2309
2689	横森	ヨコモリ	271	2679	5696162	83.2349
2690	江沢	エザワ	270	2690	5696432	83.2388
2691	尾花	オバナ	270	2690	5696702	83.2428
2692	田浦	タウラ	270	2690	5696972	83.2467
2693	立野	タテノ	270	2690	5697242	83.2507
2694	藤尾	フジオ	270	2690	5697512	83.2546
2695	二村	フタムラ	270	2690	5697782	83.2586
2696	桝田	マスダ	270	2690	5698052	83.2625
2697	青井	アオイ	269	2697	5698321	83.2664
2698	芦原	アシハラ	269	2697	5698590	83.2704
2699	梅崎	ウメザキ	269	2697	5698859	83.2743
2700	木目田	キメダ	269	2697	5699128	83.2782
2701	小金	コガネ	269	2697	5699397	83.2822
2702	三神	ミカミ	269	2697	5699666	83.2861
2703	谷島	ヤジマ	269	2697	5699935	83.29
2704	伊波	イナミ	268	2704	5700203	83.2939
2705	金田	カネタ	268	2704	5700471	83.2979
2706	郡	コオリ	268	2704	5700739	83.3018
2707	先崎	センザキ	268	2704	5701007	83.3057
2708	都丸	トマル	268	2704	5701275	83.3096
2709	広木	ヒロキ	268	2704	5701543	83.3135
2710	美濃口	ミノグチ	268	2704	5701811	83.3174
2711	深山	ミヤマ	268	2704	5702079	83.3213
2712	上間	ウエマ	267	2712	5702346	83.3253
2713	梅谷	ウメタニ	267	2712	5702613	83.3292
2714	岡沢	オカザワ	267	2712	5702880	83.3331
2715	斉田	サイダ	267	2712	5703147	83.337
2716	隅田	スミダ	267	2712	5703414	83.3409
2717	外崎	トノサキ	267	2712	5703681	83.3448
2718	萩谷	ハギヤ	267	2712	5703948	83.3487
2719	宮園	ミヤゾノ	267	2712	5704215	83.3526
2720	室	ムロ	267	2712	5704482	83.3565
2721	今成	イマナリ	266	2721	5704748	83.3603
2722	奥脇	オクワキ	266	2721	5705014	83.3642
2723	高見沢	タカミザワ	266	2721	5705280	83.3681
2724	森久保	モリクボ	266	2721	5705546	83.372
2725	神長	カミナガ	265	2725	5705811	83.3759
2726	亀崎	カメザキ	265	2725	5706076	83.3798
2727	熊谷	クマガヤ	265	2725	5706341	83.3836
2728	住田	スミタ	265	2725	5706606	83.3875
2729	谷合	タニアイ	265	2725	5706871	83.3914
2730	東野	ヒガシノ	265	2725	5707136	83.3952
2731	市瀬	イチノセ	264	2731	5707400	83.3991
2732	魚住	ウオズミ	264	2731	5707664	83.403
2733	大池	オオイケ	264	2731	5707928	83.4068
2734	川元	カワモト	264	2731	5708192	83.4107
2735	島森	シマモリ	264	2731	5708456	83.4145
2736	新井田	ニイダ	264	2731	5708720	83.4184
2737	渡	ワタリ	264	2731	5708984	83.4222
2738	■谷	タカヤ	263	2738	5709247	83.4261
2739	礒部	イソベ	262	2739	5709509	83.4299
2740	武尾	タケオ	262	2739	5709771	83.4337
2741	藁科	ワラシナ	262	2739	5710033	83.4376
2742	小松田	コマツダ	261	2742	5710294	83.4414
2743	佐治	サジ	261	2742	5710555	83.4452
2744	春原	スノハラ	261	2742	5710816	83.449
2745	夏井	ナツイ	261	2742	5711077	83.4528
2746	菱田	ヒシダ	261	2742	5711338	83.4566
2747	正岡	マサオカ	261	2742	5711599	83.4605
2748	鵜飼	ウガイ	260	2748	5711859	83.4643
2749	糟谷	カスヤ	260	2748	5712119	83.4681
2750	嘉藤	カトウ	260	2748	5712379	83.4719
2751	草場	クサバ	260	2748	5712639	83.4757
2752	久保井	クボイ	260	2748	5712899	83.4795
2753	竹森	タケモリ	260	2748	5713159	83.4833
2754	名古屋	ナゴヤ	260	2748	5713419	83.4871
2755	羽根田	ハネダ	260	2748	5713679	83.4909
2756	武者	ムシヤ	260	2748	5713939	83.4947
2757	新垣	アラガキ	259	2757	5714198	83.4984
2758	上坂	ウエサカ	259	2757	5714457	83.5022
2759	尾登	オノボリ	259	2757	5714716	83.506
2760	古関	コセキ	259	2757	5714975	83.5098
2761	仲西	ナカニシ	259	2757	5715234	83.5136
2762	行谷	ナメガヤ	259	2757	5715493	83.5174
2763	安保	アンボ	258	2763	5715751	83.5211
2764	神永	カミナガ	258	2763	5716009	83.5249
2765	武智	タケチ	258	2763	5716267	83.5287
2766	一寸木	チヨツキ	258	2763	5716525	83.5324
2767	豊永	トヨナガ	258	2763	5716783	83.5362
2768	南里	ナンリ	258	2763	5717041	83.54
2769	森元	モリモト	258	2763	5717299	83.5438
2770	秋月	アキヅキ	257	2770	5717556	83.5475
2771	■森	タカモリ	257	2770	5717813	83.5513
2772	江波戸	エバト	256	2772	5718069	83.555
2773	椎葉	シイバ	256	2772	5718325	83.5587
2774	島倉	シマクラ	256	2772	5718581	83.5625
2775	瀧川	タキガワ	256	2772	5718837	83.5662
2776	日暮	ヒグラシ	256	2772	5719093	83.57
2777	星山	ホシヤマ	256	2772	5719349	83.5737
2778	猪熊	イノクマ	255	2778	5719604	83.5774
2779	近	コン	255	2778	5719859	83.5812
2780	■部	タカベ	255	2778	5720114	83.5849
2781	永江	ナガエ	255	2778	5720369	83.5886
2782	沼上	ヌマカミ	255	2778	5720624	83.5923
2783	遠田	エンダ	254	2783	5720878	83.596
2784	土山	ツチヤマ	254	2783	5721132	83.5998
2785	古畑	フルハタ	254	2783	5721386	83.6035
2786	穴沢	アナザワ	253	2786	5721639	83.6072
2787	瓜生	ウリユウ	253	2786	5721892	83.6109
2788	酒匂	サコウ	253	2786	5722145	83.6146
2789	末廣	スエヒロ	253	2786	5722398	83.6183
2790	石関	イシゼキ	252	2790	5722650	83.6219
2791	小田島	オダシマ	252	2790	5722902	83.6256
2792	川岸	カワギシ	252	2790	5723154	83.6293
2793	木嶋	キジマ	252	2790	5723406	83.633
2794	国吉	クニヨシ	252	2790	5723658	83.6367
2795	佐相	サソウ	252	2790	5723910	83.6404
2796	芝本	シバモト	252	2790	5724162	83.644
2797	朱	シユ	252	2790	5724414	83.6477
2798	長谷	ナガタニ	252	2790	5724666	83.6514
2799	永見	ナガミ	252	2790	5724918	83.6551
2800	野見山	ノミヤマ	252	2790	5725170	83.6588
2801	天利	アマリ	251	2801	5725421	83.6624
2802	伊勢田	イセダ	251	2801	5725672	83.6661
2803	板井	イタイ	251	2801	5725923	83.6698
2804	沖野	オキノ	251	2801	5726174	83.6734
2805	古閑	コガ	251	2801	5726425	83.6771
2806	羽田野	ハタノ	251	2801	5726676	83.6808
2807	原野	ハラノ	251	2801	5726927	83.6844
2808	平子	ヒラコ	251	2801	5727178	83.6881
2809	本吉	モトヨシ	251	2801	5727429	83.6918
2810	渡会	ワタライ	251	2801	5727680	83.6954
2811	井藤	イトウ	250	2811	5727930	83.6991
2812	黒柳	クロヤナギ	250	2811	5728180	83.7027
2813	桜木	サクラギ	250	2811	5728430	83.7064
2814	塩谷	シオタニ	250	2811	5728680	83.7101
2815	長■	ナガサキ	250	2811	5728930	83.7137
2816	成松	ナリマツ	250	2811	5729180	83.7174
2817	宮里	ミヤサト	250	2811	5729430	83.721
2818	宮台	ミヤダイ	250	2811	5729680	83.7247
2819	湯原	ユハラ	250	2811	5729930	83.7283
2820	尾上	オノエ	249	2820	5730179	83.732
2821	西城	サイジヨウ	249	2820	5730428	83.7356
2822	杉岡	スギオカ	249	2820	5730677	83.7392
2823	中崎	ナカザキ	249	2820	5730926	83.7429
2824	楢原	ナラハラ	249	2820	5731175	83.7465
2825	箱崎	ハコザキ	249	2820	5731424	83.7502
2826	花木	ハナキ	249	2820	5731673	83.7538
2827	広島	ヒロシマ	249	2820	5731922	83.7574
2828	江間	エマ	248	2828	5732170	83.7611
2829	桐生	キリウ	248	2828	5732418	83.7647
2830	越水	コシミズ	248	2828	5732666	83.7683
2831	杉澤	スギサワ	248	2828	5732914	83.7719
2832	永谷	ナガタニ	248	2828	5733162	83.7755
2833	吾妻	アヅマ	247	2833	5733409	83.7792
2834	池辺	イケベ	247	2833	5733656	83.7828
2835	石松	イシマツ	247	2833	5733903	83.7864
2836	市来	イチキ	247	2833	5734150	83.79
2837	大蔵	オオクラ	247	2833	5734397	83.7936
2838	小長谷	コナガヤ	247	2833	5734644	83.7972
2839	相楽	サガラ	247	2833	5734891	83.8008
2840	俵	タワラ	247	2833	5735138	83.8044
2841	新関	ニイゼキ	247	2833	5735385	83.808
2842	向笠	ムカサ	247	2833	5735632	83.8116
2843	山尾	ヤマオ	247	2833	5735879	83.8152
2844	印南	インナミ	246	2844	5736125	83.8188
2845	鈴村	スズムラ	246	2844	5736371	83.8224
2846	野渡	ノワタリ	246	2844	5736617	83.826
2847	菱倉	ヒシクラ	246	2844	5736863	83.8296
2848	有井	アリイ	245	2848	5737108	83.8332
2849	伊井	イイ	245	2848	5737353	83.8368
2850	一木	イチキ	245	2848	5737598	83.8404
2851	加島	カシマ	245	2848	5737843	83.8439
2852	門井	カドイ	245	2848	5738088	83.8475
2853	川邊	カワベ	245	2848	5738333	83.8511
2854	小石川	コイシカワ	245	2848	5738578	83.8547
2855	古藤	コトウ	245	2848	5738823	83.8583
2856	子安	コヤス	245	2848	5739068	83.8618
2857	金	コン	245	2848	5739313	83.8654
2858	中曽根	ナカソネ	245	2848	5739558	83.869
2859	畑田	ハタダ	245	2848	5739803	83.8726
2860	宗形	ムナカタ	245	2848	5740048	83.8762
2861	横堀	ヨコボリ	245	2848	5740293	83.8797
2862	久慈	クジ	244	2862	5740537	83.8833
2863	小岩井	コイワイ	244	2862	5740781	83.8869
2864	白須	シラス	244	2862	5741025	83.8904
2865	津金	ツガネ	244	2862	5741269	83.894
2866	中上	ナカガミ	244	2862	5741513	83.8976
2867	名越	ナゴシ	244	2862	5741757	83.9011
2868	古尾谷	フルオヤ	244	2862	5742001	83.9047
2869	赤星	アカホシ	243	2869	5742244	83.9083
2870	穐本	アキモト	243	2869	5742487	83.9118
2871	畔上	アゼガミ	243	2869	5742730	83.9154
2872	伊波	イハ	243	2869	5742973	83.9189
2873	海老根	エビネ	243	2869	5743216	83.9225
2874	勝村	カツムラ	243	2869	5743459	83.926
2875	桂田	カツラダ	243	2869	5743702	83.9296
2876	菅家	カンケ	243	2869	5743945	83.9331
2877	醍醐	ダイゴ	243	2869	5744188	83.9367
2878	福富	フクトミ	243	2869	5744431	83.9402
2879	室岡	ムロオカ	243	2869	5744674	83.9438
2880	簗瀬	ヤナセ	243	2869	5744917	83.9473
2881	八尋	ヤヒロ	243	2869	5745160	83.9509
2882	伊田	イダ	242	2882	5745402	83.9544
2883	小河原	オガワラ	242	2882	5745644	83.9579
2884	何	カ	242	2882	5745886	83.9615
2885	新妻	ニイツマ	242	2882	5746128	83.965
2886	不破	フワ	242	2882	5746370	83.9685
2887	増子	マシコ	242	2882	5746612	83.9721
2888	丸井	マルイ	242	2882	5746854	83.9756
2889	三森	ミモリ	242	2882	5747096	83.9792
2890	薬師寺	ヤクシジ	242	2882	5747338	83.9827
2891	安食	アジキ	241	2891	5747579	83.9862
2892	新庄	シンジヨウ	241	2891	5747820	83.9897
2893	清田	セイダ	241	2891	5748061	83.9933
2894	鴇田	トキタ	241	2891	5748302	83.9968
2895	外岡	トノオカ	241	2891	5748543	84.0003
2896	中内	ナカウチ	241	2891	5748784	84.0038
2897	宮林	ミヤバヤシ	241	2891	5749025	84.0073
2898	石部	イシベ	240	2898	5749265	84.0109
2899	末広	スエヒロ	240	2898	5749505	84.0144
2900	■須	タカス	240	2898	5749745	84.0179
2901	多胡	タゴ	240	2898	5749985	84.0214
2902	原沢	ハラサワ	240	2898	5750225	84.0249
2903	播磨	ハリマ	240	2898	5750465	84.0284
2904	水間	ミズマ	240	2898	5750705	84.0319
2905	押川	オシカワ	239	2905	5750944	84.0354
2906	國井	クニイ	239	2905	5751183	84.0389
2907	佐保田	サホダ	239	2905	5751422	84.0424
2908	渋井	シブイ	239	2905	5751661	84.0459
2909	綱川	ツナカワ	239	2905	5751900	84.0494
2910	鳥飼	トリカイ	239	2905	5752139	84.0528
2911	古谷	フルタニ	239	2905	5752378	84.0563
2912	池澤	イケザワ	238	2912	5752616	84.0598
2913	柿原	カキハラ	238	2912	5752854	84.0633
2914	角谷	カクタニ	238	2912	5753092	84.0668
2915	小須田	コスダ	238	2912	5753330	84.0703
2916	権藤	ゴンドウ	238	2912	5753568	84.0737
2917	澤木	サワキ	238	2912	5753806	84.0772
2918	■木	タカキ	238	2912	5754044	84.0807
2919	■畑	タカハタ	238	2912	5754282	84.0842
2920	高安	タカヤス	238	2912	5754520	84.0876
2921	又吉	マタヨシ	238	2912	5754758	84.0911
2922	八木澤	ヤギサワ	238	2912	5754996	84.0946
2923	入山	イリヤマ	237	2923	5755233	84.0981
2924	岩木	イワキ	237	2923	5755470	84.1015
2925	梅山	ウメヤマ	237	2923	5755707	84.105
2926	大房	オオフサ	237	2923	5755944	84.1084
2927	尾方	オガタ	237	2923	5756181	84.1119
2928	小田嶋	オダジマ	237	2923	5756418	84.1154
2929	兼松	カネマツ	237	2923	5756655	84.1188
2930	霧生	キリウ	237	2923	5756892	84.1223
2931	三宮	サンノミヤ	237	2923	5757129	84.1258
2932	泉水	センスイ	237	2923	5757366	84.1292
2933	友利	トモリ	237	2923	5757603	84.1327
2934	秋場	アキバ	236	2934	5757839	84.1361
2935	圷	アクツ	236	2934	5758075	84.1396
2936	石谷	イシタニ	236	2934	5758311	84.143
2937	一之瀬	イチノセ	236	2934	5758547	84.1465
2938	佐渡	サド	236	2934	5758783	84.1499
2939	中間	ナカマ	236	2934	5759019	84.1534
2940	稗田	ヒエダ	236	2934	5759255	84.1568
2941	梁	リヨウ	236	2934	5759491	84.1603
2942	鬼塚	オニヅカ	235	2942	5759726	84.1637
2943	境野	サカイノ	235	2942	5759961	84.1671
2944	鶴	ツル	235	2942	5760196	84.1706
2945	藤堂	トウドウ	235	2942	5760431	84.174
2946	沼尾	ヌマオ	235	2942	5760666	84.1774
2947	野々山	ノノヤマ	235	2942	5760901	84.1809
2948	吉富	ヨシトミ	235	2942	5761136	84.1843
2949	赤沼	アカヌマ	234	2949	5761370	84.1877
2950	小此木	オコノギ	234	2949	5761604	84.1912
2951	古知屋	コチヤ	234	2949	5761838	84.1946
2952	雑賀	サイガ	234	2949	5762072	84.198
2953	阪田	サカタ	234	2949	5762306	84.2014
2954	畠	ハタ	234	2949	5762540	84.2048
2955	間野	マノ	234	2949	5762774	84.2083
2956	岩根	イワネ	233	2956	5763007	84.2117
2957	勝木	カツキ	233	2956	5763240	84.2151
2958	川鍋	カワナベ	233	2956	5763473	84.2185
2959	紅林	クレバヤシ	233	2956	5763706	84.2219
2960	関澤	セキザワ	233	2956	5763939	84.2253
2961	荒金	アラガネ	232	2961	5764171	84.2287
2962	加々美	カガミ	232	2961	5764403	84.2321
2963	鴨川	カモガワ	232	2961	5764635	84.2354
2964	川窪	カワクボ	232	2961	5764867	84.2388
2965	笹沼	ササヌマ	232	2961	5765099	84.2422
2966	戸上	トガミ	232	2961	5765331	84.2456
2967	永倉	ナガクラ	232	2961	5765563	84.249
2968	古舘	フルダテ	232	2961	5765795	84.2524
2969	増本	マスモト	232	2961	5766027	84.2558
2970	宮入	ミヤイリ	232	2961	5766259	84.2592
2971	芳垣	ヨシガキ	232	2961	5766491	84.2626
2972	倉澤	クラサワ	231	2972	5766722	84.2659
2973	倉科	クラシナ	231	2972	5766953	84.2693
2974	木場	コバ	231	2972	5767184	84.2727
2975	庄野	シヨウノ	231	2972	5767415	84.2761
2976	白沢	シラサワ	231	2972	5767646	84.2794
2977	高垣	タカガキ	231	2972	5767877	84.2828
2978	高沢	タカサワ	231	2972	5768108	84.2862
2979	茂木	モテキ	231	2972	5768339	84.2896
2980	柳本	ヤナギモト	231	2972	5768570	84.2929
2981	大井川	オオイガワ	230	2981	5768800	84.2963
2982	押野	オシノ	230	2981	5769030	84.2997
2983	海津	カイヅ	230	2981	5769260	84.303
2984	唐木	カラキ	230	2981	5769490	84.3064
2985	河端	カワバタ	230	2981	5769720	84.3097
2986	神■	カンザキ	230	2981	5769950	84.3131
2987	鯨井	クジライ	230	2981	5770180	84.3165
2988	笹谷	ササヤ	230	2981	5770410	84.3198
2989	庄田	シヨウダ	230	2981	5770640	84.3232
2990	瀬間	セマ	230	2981	5770870	84.3266
2991	向	ムカイ	230	2981	5771100	84.3299
2992	森内	モリウチ	230	2981	5771330	84.3333
2993	森重	モリシゲ	230	2981	5771560	84.3366
2994	愛甲	アイコウ	229	2994	5771789	84.34
2995	朝田	アサダ	229	2994	5772018	84.3433
2996	安楽	アンラク	229	2994	5772247	84.3467
2997	柿島	カキシマ	229	2994	5772476	84.35
2998	倉形	クラカタ	229	2994	5772705	84.3534
2999	志沢	シザワ	229	2994	5772934	84.3567
3000	鈴田	スズタ	229	2994	5773163	84.3601
3001	住谷	スミヤ	229	2994	5773392	84.3634
3002	田内	タウチ	229	2994	5773621	84.3668
3003	寺下	テラシタ	229	2994	5773850	84.3701
3004	沼沢	ヌマザワ	229	2994	5774079	84.3734
3005	福間	フクマ	229	2994	5774308	84.3768
3006	前	マエ	229	2994	5774537	84.3801
3007	岡澤	オカザワ	228	3007	5774765	84.3835
3008	荻島	オギシマ	228	3007	5774993	84.3868
3009	京極	キヨウゴク	228	3007	5775221	84.3901
3010	倉石	クライシ	228	3007	5775449	84.3935
3011	黒石	クロイシ	228	3007	5775677	84.3968
3012	成川	ナルカワ	228	3007	5775905	84.4001
3013	藤永	フジナガ	228	3007	5776133	84.4035
3014	大柴	オオシバ	227	3014	5776360	84.4068
3015	岡庭	オカニワ	227	3014	5776587	84.4101
3016	小串	オグシ	227	3014	5776814	84.4134
3017	梶本	カジモト	227	3014	5777041	84.4167
3018	神成	カンナリ	227	3014	5777268	84.42
3019	世古	セコ	227	3014	5777495	84.4234
3020	■宮	タカミヤ	227	3014	5777722	84.4267
3021	巽	タツミ	227	3014	5777949	84.43
3022	東海林	トウカイリン	227	3014	5778176	84.4333
3023	沼澤	ヌマザワ	227	3014	5778403	84.4366
3024	古庄	フルシヨウ	227	3014	5778630	84.4399
3025	三縄	ミナワ	227	3014	5778857	84.4433
3026	宮山	ミヤヤマ	227	3014	5779084	84.4466
3027	青砥	アオト	226	3027	5779310	84.4499
3028	赤荻	アカオギ	226	3027	5779536	84.4532
3029	表	オモテ	226	3027	5779762	84.4565
3030	柏谷	カシワヤ	226	3027	5779988	84.4598
3031	梶谷	カジガヤ	226	3027	5780214	84.4631
3032	小塩	コシオ	226	3027	5780440	84.4664
3033	小間	コマ	226	3027	5780666	84.4697
3034	眞田	サナダ	226	3027	5780892	84.473
3035	茂田	シゲタ	226	3027	5781118	84.4763
3036	塚野	ツカノ	226	3027	5781344	84.4796
3037	土佐	トサ	226	3027	5781570	84.4829
3038	中里	ナカサト	226	3027	5781796	84.4862
3039	成島	ナルシマ	226	3027	5782022	84.4895
3040	前嶋	マエジマ	226	3027	5782248	84.4928
3041	光永	ミツナガ	226	3027	5782474	84.4961
3042	石戸	イシド	225	3042	5782699	84.4994
3043	糸川	イトカワ	225	3042	5782924	84.5027
3044	大谷	オオヤ	225	3042	5783149	84.506
3045	黒部	クロベ	225	3042	5783374	84.5093
3046	浜名	ハマナ	225	3042	5783599	84.5126
3047	平綿	ヒラワタ	225	3042	5783824	84.5158
3048	元田	モトダ	225	3042	5784049	84.5191
3049	安富	ヤストミ	225	3042	5784274	84.5224
3050	秋沢	アキサワ	224	3050	5784498	84.5257
3051	石堂	イシドウ	224	3050	5784722	84.529
3052	磯山	イソヤマ	224	3050	5784946	84.5322
3053	奥本	オクモト	224	3050	5785170	84.5355
3054	河津	カワヅ	224	3050	5785394	84.5388
3055	滝野	タキノ	224	3050	5785618	84.5421
3056	土川	ツチカワ	224	3050	5785842	84.5453
3057	仲里	ナカザト	224	3050	5786066	84.5486
3058	間島	マジマ	224	3050	5786290	84.5519
3059	横野	ヨコノ	224	3050	5786514	84.5552
3060	小佐野	オサノ	223	3060	5786737	84.5584
3061	神蔵	カミクラ	223	3060	5786960	84.5617
3062	蒲生	ガモウ	223	3060	5787183	84.5649
3063	窪	クボ	223	3060	5787406	84.5682
3064	熊田	クマタ	223	3060	5787629	84.5714
3065	立木	タチキ	223	3060	5787852	84.5747
3066	中垣	ナカガキ	223	3060	5788075	84.578
3067	納谷	ナヤ	223	3060	5788298	84.5812
3068	羽太	ハブト	223	3060	5788521	84.5845
3069	深山	フカヤマ	223	3060	5788744	84.5877
3070	藤林	フジバヤシ	223	3060	5788967	84.591
3071	横地	ヨコチ	223	3060	5789190	84.5943
3072	岩上	イワガミ	222	3072	5789412	84.5975
3073	大日方	オビナタ	222	3072	5789634	84.6007
3074	笹生	ササオ	222	3072	5789856	84.604
3075	関川	セキガワ	222	3072	5790078	84.6072
3076	豊原	トヨハラ	222	3072	5790300	84.6105
3077	新岡	ニイオカ	222	3072	5790522	84.6137
3078	福谷	フクタニ	222	3072	5790744	84.617
3079	山井	ヤマイ	222	3072	5790966	84.6202
3080	山野辺	ヤマノベ	222	3072	5791188	84.6234
3081	小渕	オブチ	221	3081	5791409	84.6267
3082	金坂	カネサカ	221	3081	5791630	84.6299
3083	宝田	タカラダ	221	3081	5791851	84.6331
3084	西久保	ニシクボ	221	3081	5792072	84.6364
3085	百武	ヒヤクタケ	221	3081	5792293	84.6396
3086	南川	ミナミカワ	221	3081	5792514	84.6428
3087	柚木	ユノキ	221	3081	5792735	84.6461
3088	岩月	イワツキ	220	3088	5792955	84.6493
3089	須原	スハラ	220	3088	5793175	84.6525
3090	外山	ソトヤマ	220	3088	5793395	84.6557
3091	樋田	ヒダ	220	3088	5793615	84.6589
3092	程島	ホドシマ	220	3088	5793835	84.6621
3093	武笠	ムカサ	220	3088	5794055	84.6653
3094	入倉	イリクラ	219	3094	5794274	84.6685
3095	柄沢	カラサワ	219	3094	5794493	84.6717
3096	蔵本	クラモト	219	3094	5794712	84.6749
3097	昆野	コンノ	219	3094	5794931	84.6781
3098	杉下	スギシタ	219	3094	5795150	84.6813
3099	舘山	タテヤマ	219	3094	5795369	84.6845
3100	直江	ナオエ	219	3094	5795588	84.6877
3101	三須	ミス	219	3094	5795807	84.6909
3102	薮田	ヤブタ	219	3094	5796026	84.6941
3103	■永	ヨシナガ	219	3094	5796245	84.6973
3104	力石	リキイシ	219	3094	5796464	84.7005
3105	大出	オオデ	218	3105	5796682	84.7037
3106	貝塚	カイヅカ	218	3105	5796900	84.7069
3107	上林	カミバヤシ	218	3105	5797118	84.7101
3108	唐鎌	カラカマ	218	3105	5797336	84.7133
3109	■澤	タカザワ	218	3105	5797554	84.7165
3110	津山	ツヤマ	218	3105	5797772	84.7197
3111	手嶋	テジマ	218	3105	5797990	84.7228
3112	徳重	トクシゲ	218	3105	5798208	84.726
3113	野末	ノズエ	218	3105	5798426	84.7292
3114	浜川	ハマカワ	218	3105	5798644	84.7324
3115	東出	ヒガシデ	218	3105	5798862	84.7356
3116	与那嶺	ヨナミネ	218	3105	5799080	84.7388
3117	飯沢	イイザワ	217	3117	5799297	84.7419
3118	岩室	イワムロ	217	3117	5799514	84.7451
3119	江良	エラ	217	3117	5799731	84.7483
3120	樺沢	カバサワ	217	3117	5799948	84.7515
3121	越地	コシジ	217	3117	5800165	84.7546
3122	沢辺	サワベ	217	3117	5800382	84.7578
3123	芝原	シバハラ	217	3117	5800599	84.761
3124	高坂	タカサカ	217	3117	5800816	84.7641
3125	長濱	ナガハマ	217	3117	5801033	84.7673
3126	長原	ナガハラ	217	3117	5801250	84.7705
3127	西堀	ニシボリ	217	3117	5801467	84.7737
3128	平瀬	ヒラセ	217	3117	5801684	84.7768
3129	深尾	フカオ	217	3117	5801901	84.78
3130	安居院	アグイ	216	3130	5802117	84.7831
3131	亀谷	カメタニ	216	3130	5802333	84.7863
3132	苅部	カルベ	216	3130	5802549	84.7895
3133	櫛引	クシビキ	216	3130	5802765	84.7926
3134	角谷	スミヤ	216	3130	5802981	84.7958
3135	蛭間	ヒルマ	216	3130	5803197	84.7989
3136	幕田	マクタ	216	3130	5803413	84.8021
3137	増永	マスナガ	216	3130	5803629	84.8052
3138	宮戸	ミヤト	216	3130	5803845	84.8084
3139	横関	ヨコゼキ	216	3130	5804061	84.8116
3140	秋庭	アキバ	215	3140	5804276	84.8147
3141	奥寺	オクデラ	215	3140	5804491	84.8178
3142	柿■	カキザキ	215	3140	5804706	84.821
3143	倉内	クラウチ	215	3140	5804921	84.8241
3144	繁田	シゲタ	215	3140	5805136	84.8273
3145	田倉	タクラ	215	3140	5805351	84.8304
3146	戸嶋	トシマ	215	3140	5805566	84.8335
3147	橋村	ハシムラ	215	3140	5805781	84.8367
3148	花沢	ハナザワ	215	3140	5805996	84.8398
3149	福留	フクトメ	215	3140	5806211	84.843
3150	堀本	ホリモト	215	3140	5806426	84.8461
3151	吉原	ヨシワラ	215	3140	5806641	84.8493
3152	網代	アジロ	214	3152	5806855	84.8524
3153	足立原	アダチハラ	214	3152	5807069	84.8555
3154	梅川	ウメカワ	214	3152	5807283	84.8586
3155	亀谷	カメヤ	214	3152	5807497	84.8618
3156	芝山	シバヤマ	214	3152	5807711	84.8649
3157	新保	シンポ	214	3152	5807925	84.868
3158	夏苅	ナツガリ	214	3152	5808139	84.8711
3159	橋元	ハシモト	214	3152	5808353	84.8743
3160	長谷山	ハセヤマ	214	3152	5808567	84.8774
3161	古井	フルイ	214	3152	5808781	84.8805
3162	槙	マキ	214	3152	5808995	84.8837
3163	吉池	ヨシイケ	214	3152	5809209	84.8868
3164	■坂	コウサカ	213	3164	5809422	84.8899
3165	國分	コクブ	213	3164	5809635	84.893
3166	曽田	ソダ	213	3164	5809848	84.8961
3167	伴野	バンノ	213	3164	5810061	84.8992
3168	小高	オダカ	212	3168	5810273	84.9023
3169	黒■	クロサキ	212	3168	5810485	84.9054
3170	黄金井	コガネイ	212	3168	5810697	84.9085
3171	島岡	シマオカ	212	3168	5810909	84.9116
3172	戸松	トマツ	212	3168	5811121	84.9147
3173	奈須	ナス	212	3168	5811333	84.9178
3174	西ケ谷	ニシガヤ	212	3168	5811545	84.9209
3175	昼間	ヒルマ	212	3168	5811757	84.924
3176	森戸	モリト	212	3168	5811969	84.9271
3177	穐山	アキヤマ	211	3177	5812180	84.9302
3178	旭	アサヒ	211	3177	5812391	84.9333
3179	市丸	イチマル	211	3177	5812602	84.9364
3180	隈元	クマモト	211	3177	5812813	84.9394
3181	田久保	タクボ	211	3177	5813024	84.9425
3182	宅間	タクマ	211	3177	5813235	84.9456
3183	行方	ナメカタ	211	3177	5813446	84.9487
3184	三樹	ミキ	211	3177	5813657	84.9518
3185	御園	ミソノ	211	3177	5813868	84.9549
3186	三武	ミタケ	211	3177	5814079	84.9579
3187	峰村	ミネムラ	211	3177	5814290	84.961
3188	若宮	ワカミヤ	211	3177	5814501	84.9641
3189	今橋	イマハシ	210	3189	5814711	84.9672
3190	浦部	ウラベ	210	3189	5814921	84.9702
3191	瀬口	セグチ	210	3189	5815131	84.9733
3192	竹岡	タケオカ	210	3189	5815341	84.9764
3193	栃木	トチギ	210	3189	5815551	84.9795
3194	綿引	ワタビキ	210	3189	5815761	84.9825
3195	浅間	アサマ	209	3195	5815970	84.9856
3196	稲森	イナモリ	209	3195	5816179	84.9886
3197	荏原	エバラ	209	3195	5816388	84.9917
3198	荻山	オギヤマ	209	3195	5816597	84.9947
3199	沓沢	クツザワ	209	3195	5816806	84.9978
3200	砂山	スナヤマ	209	3195	5817015	85.0008
3201	舘	タテ	209	3195	5817224	85.0039
3202	仲井	ナカイ	209	3195	5817433	85.007
3203	野路	ノジ	209	3195	5817642	85.01
3204	野辺	ノベ	209	3195	5817851	85.0131
3205	■	リユウ	209	3195	5818060	85.0161
3206	秋沢	アキザワ	208	3206	5818268	85.0192
3207	新居	アライ	208	3206	5818476	85.0222
3208	井内	イウチ	208	3206	5818684	85.0252
3209	稲木	イナギ	208	3206	5818892	85.0283
3210	瓜生	ウリウ	208	3206	5819100	85.0313
3211	榎戸	エノキド	208	3206	5819308	85.0344
3212	大輪	オオワ	208	3206	5819516	85.0374
3213	久木田	クキタ	208	3206	5819724	85.0404
3214	倉地	クラチ	208	3206	5819932	85.0435
3215	駒村	コマムラ	208	3206	5820140	85.0465
3216	酒寄	サカヨリ	208	3206	5820348	85.0495
3217	嶋本	シマモト	208	3206	5820556	85.0526
3218	永森	ナガモリ	208	3206	5820764	85.0556
3219	藤元	フジモト	208	3206	5820972	85.0587
3220	横澤	ヨコザワ	208	3206	5821180	85.0617
3221	穴澤	アナザワ	207	3221	5821387	85.0647
3222	阿保	アボ	207	3221	5821594	85.0678
3223	井浦	イウラ	207	3221	5821801	85.0708
3224	海老沼	エビヌマ	207	3221	5822008	85.0738
3225	蛯原	エビハラ	207	3221	5822215	85.0768
3226	大武	オオタケ	207	3221	5822422	85.0799
3227	加治	カジ	207	3221	5822629	85.0829
3228	加部	カベ	207	3221	5822836	85.0859
3229	川中	カワナカ	207	3221	5823043	85.0889
3230	川野辺	カワノベ	207	3221	5823250	85.092
3231	久世	クゼ	207	3221	5823457	85.095
3232	車田	クルマダ	207	3221	5823664	85.098
3233	佐古	サコ	207	3221	5823871	85.101
3234	下沢	シモザワ	207	3221	5824078	85.1041
3235	二村	ニムラ	207	3221	5824285	85.1071
3236	沼崎	ヌマザキ	207	3221	5824492	85.1101
3237	間山	マヤマ	207	3221	5824699	85.1131
3238	三ッ橋	ミツハシ	207	3221	5824906	85.1162
3239	山寺	ヤマデラ	207	3221	5825113	85.1192
3240	赤羽	アカバ	206	3240	5825319	85.1222
3241	臼杵	ウスキ	206	3240	5825525	85.1252
3242	枝	エダ	206	3240	5825731	85.1282
3243	江畑	エバタ	206	3240	5825937	85.1312
3244	岡嶋	オカジマ	206	3240	5826143	85.1342
3245	尾沢	オザワ	206	3240	5826349	85.1372
3246	菊間	キクマ	206	3240	5826555	85.1402
3247	沢木	サワキ	206	3240	5826761	85.1433
3248	武市	タケイチ	206	3240	5826967	85.1463
3249	谷崎	タニザキ	206	3240	5827173	85.1493
3250	蜂須賀	ハチスカ	206	3240	5827379	85.1523
3251	岡井	オカイ	205	3251	5827584	85.1553
3252	楠原	クスハラ	205	3251	5827789	85.1583
3253	宮平	ミヤヒラ	205	3251	5827994	85.1613
3254	元山	モトヤマ	205	3251	5828199	85.1643
3255	藍田	アイダ	204	3255	5828403	85.1673
3256	足達	アダチ	204	3255	5828607	85.1702
3257	碇	イカリ	204	3255	5828811	85.1732
3258	奥川	オクガワ	204	3255	5829015	85.1762
3259	上川	カミカワ	204	3255	5829219	85.1792
3260	許	キヨ	204	3255	5829423	85.1822
3261	小瀬	コセ	204	3255	5829627	85.1851
3262	茅野	チノ	204	3255	5829831	85.1881
3263	根来	ネゴロ	204	3255	5830035	85.1911
3264	羽根	ハネ	204	3255	5830239	85.1941
3265	秀島	ヒデシマ	204	3255	5830443	85.1971
3266	細山	ホソヤマ	204	3255	5830647	85.2
3267	市岡	イチオカ	203	3267	5830850	85.203
3268	岩壁	イワカベ	203	3267	5831053	85.206
3269	海保	カイホ	203	3267	5831256	85.2089
3270	賀川	カガワ	203	3267	5831459	85.2119
3271	倉岡	クラオカ	203	3267	5831662	85.2149
3272	神津	コウヅ	203	3267	5831865	85.2178
3273	竹尾	タケオ	203	3267	5832068	85.2208
3274	都筑	ツヅキ	203	3267	5832271	85.2238
3275	速水	ハヤミ	203	3267	5832474	85.2267
3276	前村	マエムラ	203	3267	5832677	85.2297
3277	溝渕	ミゾブチ	203	3267	5832880	85.2327
3278	梶浦	カジウラ	202	3278	5833082	85.2356
3279	永石	ナガイシ	202	3278	5833284	85.2386
3280	花澤	ハナザワ	202	3278	5833486	85.2415
3281	針生	ハリウ	202	3278	5833688	85.2445
3282	矢田部	ヤタベ	202	3278	5833890	85.2474
3283	井筒	イヅツ	201	3283	5834091	85.2504
3284	歌川	ウタガワ	201	3283	5834292	85.2533
3285	大用	オオヨウ	201	3283	5834493	85.2562
3286	川部	カワベ	201	3283	5834694	85.2592
3287	佐倉	サクラ	201	3283	5834895	85.2621
3288	佐橋	サハシ	201	3283	5835096	85.2651
3289	曽根田	ソネダ	201	3283	5835297	85.268
3290	築地	ツキジ	201	3283	5835498	85.2709
3291	中出	ナカデ	201	3283	5835699	85.2739
3292	那須野	ナスノ	201	3283	5835900	85.2768
3293	森泉	モリイズミ	201	3283	5836101	85.2797
3294	吉元	ヨシモト	201	3283	5836302	85.2827
3295	秋谷	アキヤ	200	3295	5836502	85.2856
3296	石河	イシカワ	200	3295	5836702	85.2885
3297	伊部	イベ	200	3295	5836902	85.2914
3298	氏原	ウジハラ	200	3295	5837102	85.2944
3299	小巻	コマキ	200	3295	5837302	85.2973
3300	古村	コムラ	200	3295	5837502	85.3002
3301	高浜	タカハマ	200	3295	5837702	85.3031
3302	古本	フルモト	200	3295	5837902	85.3061
3303	牧内	マキウチ	200	3295	5838102	85.309
3304	水井	ミズイ	200	3295	5838302	85.3119
3305	室橋	ムロハシ	200	3295	5838502	85.3148
3306	吉水	ヨシミズ	200	3295	5838702	85.3177
3307	米田	ヨネタ	200	3295	5838902	85.3207
3308	鮎川	アユカワ	199	3308	5839101	85.3236
3309	勝島	カツシマ	199	3308	5839300	85.3265
3310	角谷	カドヤ	199	3308	5839499	85.3294
3311	川浪	カワナミ	199	3308	5839698	85.3323
3312	木津	キヅ	199	3308	5839897	85.3352
3313	國分	コクブン	199	3308	5840096	85.3381
3314	福森	フクモリ	199	3308	5840295	85.341
3315	藤瀬	フジセ	199	3308	5840494	85.3439
3316	松居	マツイ	199	3308	5840693	85.3468
3317	尾澤	オザワ	198	3317	5840891	85.3497
3318	小田川	オダガワ	198	3317	5841089	85.3526
3319	金久保	カナクボ	198	3317	5841287	85.3555
3320	川満	カワミツ	198	3317	5841485	85.3584
3321	指田	サシダ	198	3317	5841683	85.3613
3322	重森	シゲモリ	198	3317	5841881	85.3642
3323	謝	シヤ	198	3317	5842079	85.3671
3324	諏訪間	スワマ	198	3317	5842277	85.37
3325	袖山	ソデヤマ	198	3317	5842475	85.3729
3326	蓮池	ハスイケ	198	3317	5842673	85.3758
3327	舟橋	フナハシ	198	3317	5842871	85.3787
3328	本島	モトジマ	198	3317	5843069	85.3816
3329	米満	ヨネミツ	198	3317	5843267	85.3845
3330	頼住	ヨリズミ	198	3317	5843465	85.3873
3331	阿曽	アソ	197	3331	5843662	85.3902
3332	大藤	オオフジ	197	3331	5843859	85.3931
3333	菊川	キクガワ	197	3331	5844056	85.396
3334	新開	シンカイ	197	3331	5844253	85.3989
3335	清宮	セイミヤ	197	3331	5844450	85.4017
3336	西坂	ニシザカ	197	3331	5844647	85.4046
3337	西園	ニシゾノ	197	3331	5844844	85.4075
3338	舟橋	フナバシ	197	3331	5845041	85.4104
3339	古江	フルエ	197	3331	5845238	85.4133
3340	古性	フルシヨウ	197	3331	5845435	85.4161
3341	池端	イケハタ	196	3341	5845631	85.419
3342	各務	カガミ	196	3341	5845827	85.4219
3343	神本	カミモト	196	3341	5846023	85.4247
3344	関屋	セキヤ	196	3341	5846219	85.4276
3345	出村	デムラ	196	3341	5846415	85.4305
3346	濱本	ハマモト	196	3341	5846611	85.4333
3347	丸橋	マルハシ	196	3341	5846807	85.4362
3348	八坂	ヤサカ	196	3341	5847003	85.439
3349	山宮	ヤマミヤ	196	3341	5847199	85.4419
3350	赤平	アカヒラ	195	3350	5847394	85.4448
3351	阿達	アダチ	195	3350	5847589	85.4476
3352	泉山	イズミヤマ	195	3350	5847784	85.4505
3353	金成	カナリ	195	3350	5847979	85.4533
3354	佐伯	サイキ	195	3350	5848174	85.4562
3355	作山	サクヤマ	195	3350	5848369	85.459
3356	椎谷	シイヤ	195	3350	5848564	85.4619
3357	鷲見	スミ	195	3350	5848759	85.4647
3358	瀬崎	セザキ	195	3350	5848954	85.4676
3359	谷井	タニイ	195	3350	5849149	85.4704
3360	丹波	タンバ	195	3350	5849344	85.4733
3361	長峯	ナガミネ	195	3350	5849539	85.4761
3362	深堀	フカボリ	195	3350	5849734	85.479
3363	増村	マスムラ	195	3350	5849929	85.4818
3364	松森	マツモリ	195	3350	5850124	85.4846
3365	見留	ミトメ	195	3350	5850319	85.4875
3366	三平	ミヒラ	195	3350	5850514	85.4903
3367	山瀬	ヤマセ	195	3350	5850709	85.4932
3368	石塚	イシツカ	194	3368	5850903	85.496
3369	植山	ウエヤマ	194	3368	5851097	85.4989
3370	亀ケ谷	カメガヤ	194	3368	5851291	85.5017
3371	北畠	キタバタケ	194	3368	5851485	85.5045
3372	香田	コウダ	194	3368	5851679	85.5074
3373	薗田	ソノダ	194	3368	5851873	85.5102
3374	寺坂	テラサカ	194	3368	5852067	85.513
3375	能登谷	ノトヤ	194	3368	5852261	85.5159
3376	波木井	ハキイ	194	3368	5852455	85.5187
3377	廣野	ヒロノ	194	3368	5852649	85.5215
3378	船橋	フナハシ	194	3368	5852843	85.5244
3379	間中	マナカ	194	3368	5853037	85.5272
3380	蓑田	ミノダ	194	3368	5853231	85.53
3381	貝沼	カイヌマ	193	3381	5853424	85.5329
3382	苅谷	カリヤ	193	3381	5853617	85.5357
3383	古谷田	コヤタ	193	3381	5853810	85.5385
3384	高良	タカラ	193	3381	5854003	85.5413
3385	戸井	トイ	193	3381	5854196	85.5442
3386	友部	トモベ	193	3381	5854389	85.547
3387	槇	マキ	193	3381	5854582	85.5498
3388	武蔵	ムサシ	193	3381	5854775	85.5526
3389	森沢	モリサワ	193	3381	5854968	85.5554
3390	粟竹	アワタケ	192	3390	5855160	85.5582
3391	池村	イケムラ	192	3390	5855352	85.561
3392	江連	エヅレ	192	3390	5855544	85.5638
3393	下澤	シモザワ	192	3390	5855736	85.5667
3394	谷澤	タニザワ	192	3390	5855928	85.5695
3395	原澤	ハラサワ	192	3390	5856120	85.5723
3396	峯田	ミネタ	192	3390	5856312	85.5751
3397	向原	ムコウハラ	192	3390	5856504	85.5779
3398	棟方	ムナカタ	192	3390	5856696	85.5807
3399	山部	ヤマベ	192	3390	5856888	85.5835
3400	幸	ユキ	192	3390	5857080	85.5863
3401	由利	ユリ	192	3390	5857272	85.5891
3402	赤田	アカダ	191	3402	5857463	85.5919
3403	秋澤	アキサワ	191	3402	5857654	85.5947
3404	稲富	イナトミ	191	3402	5857845	85.5975
3405	浦崎	ウラサキ	191	3402	5858036	85.6003
3406	大神田	オオカンダ	191	3402	5858227	85.6031
3407	大隈	オオクマ	191	3402	5858418	85.6058
3408	久保山	クボヤマ	191	3402	5858609	85.6086
3409	蔡	サイ	191	3402	5858800	85.6114
3410	陣内	ジンナイ	191	3402	5858991	85.6142
3411	■石	タカイシ	191	3402	5859182	85.617
3412	田野倉	タノクラ	191	3402	5859373	85.6198
3413	豊福	トヨフク	191	3402	5859564	85.6226
3414	丸島	マルシマ	191	3402	5859755	85.6254
3415	溝呂木	ミゾロキ	191	3402	5859946	85.6282
3416	三船	ミフネ	191	3402	5860137	85.631
3417	横江	ヨコエ	191	3402	5860328	85.6338
3418	虻川	アブカワ	190	3418	5860518	85.6365
3419	伊集院	イジユウイン	190	3418	5860708	85.6393
3420	江幡	エバタ	190	3418	5860898	85.6421
3421	沖本	オキモト	190	3418	5861088	85.6449
3422	久住	クスミ	190	3418	5861278	85.6476
3423	白澤	シラサワ	190	3418	5861468	85.6504
3424	徳原	トクハラ	190	3418	5861658	85.6532
3425	西舘	ニシダテ	190	3418	5861848	85.656
3426	西牧	ニシマキ	190	3418	5862038	85.6587
3427	西宮	ニシミヤ	190	3418	5862228	85.6615
3428	浜島	ハマシマ	190	3418	5862418	85.6643
3429	平嶋	ヒラシマ	190	3418	5862608	85.6671
3430	尹	ユン	190	3418	5862798	85.6698
3431	打越	ウチコシ	189	3431	5862987	85.6726
3432	河瀬	カワセ	189	3431	5863176	85.6754
3433	北尾	キタオ	189	3431	5863365	85.6781
3434	北出	キタデ	189	3431	5863554	85.6809
3435	小森谷	コモリヤ	189	3431	5863743	85.6837
3436	菅沢	スガサワ	189	3431	5863932	85.6864
3437	住友	スミトモ	189	3431	5864121	85.6892
3438	薗部	ソノベ	189	3431	5864310	85.6919
3439	竹口	タケグチ	189	3431	5864499	85.6947
3440	竹松	タケマツ	189	3431	5864688	85.6975
3441	手塚	テズカ	189	3431	5864877	85.7002
3442	東海	トウカイ	189	3431	5865066	85.703
3443	植田	ウエタ	188	3443	5865254	85.7057
3444	大出	オオイデ	188	3443	5865442	85.7085
3445	小堺	コザカイ	188	3443	5865630	85.7112
3446	新原	ニイハラ	188	3443	5865818	85.714
3447	桧垣	ヒガキ	188	3443	5866006	85.7167
3448	安住	アズミ	187	3448	5866193	85.7195
3449	猪狩	イカリ	187	3448	5866380	85.7222
3450	上西	ウエニシ	187	3448	5866567	85.7249
3451	大草	オオクサ	187	3448	5866754	85.7277
3452	金山	カネヤマ	187	3448	5866941	85.7304
3453	桐谷	キリヤ	187	3448	5867128	85.7331
3454	上妻	コウヅマ	187	3448	5867315	85.7359
3455	信太	シダ	187	3448	5867502	85.7386
3456	竹ノ内	タケノウチ	187	3448	5867689	85.7413
3457	手嶋	テシマ	187	3448	5867876	85.744
3458	手代木	テシロギ	187	3448	5868063	85.7468
3459	長根	ナガネ	187	3448	5868250	85.7495
3460	廣島	ヒロシマ	187	3448	5868437	85.7522
3461	村沢	ムラサワ	187	3448	5868624	85.755
3462	守	モリ	187	3448	5868811	85.7577
3463	横島	ヨコシマ	187	3448	5868998	85.7604
3464	若原	ワカハラ	187	3448	5869185	85.7632
3465	池崎	イケザキ	186	3465	5869371	85.7659
3466	稲沢	イナザワ	186	3465	5869557	85.7686
3467	占部	ウラベ	186	3465	5869743	85.7713
3468	北口	キタグチ	186	3465	5869929	85.774
3469	古泉	コイズミ	186	3465	5870115	85.7768
3470	白木	シロキ	186	3465	5870301	85.7795
3471	高畠	タカバタケ	186	3465	5870487	85.7822
3472	富川	トミカワ	186	3465	5870673	85.7849
3473	廣岡	ヒロオカ	186	3465	5870859	85.7876
3474	樋渡	ヒワタリ	186	3465	5871045	85.7904
3475	水原	ミズハラ	186	3465	5871231	85.7931
3476	八嶋	ヤシマ	186	3465	5871417	85.7958
3477	春日井	カスガイ	185	3477	5871602	85.7985
3478	川下	カワシタ	185	3477	5871787	85.8012
3479	木藤	キドウ	185	3477	5871972	85.8039
3480	田淵	タブチ	185	3477	5872157	85.8066
3481	中台	ナカダイ	185	3477	5872342	85.8093
3482	西部	ニシベ	185	3477	5872527	85.812
3483	沼上	ヌマガミ	185	3477	5872712	85.8147
3484	花形	ハナガタ	185	3477	5872897	85.8174
3485	光岡	ミツオカ	185	3477	5873082	85.8201
3486	門田	モンデン	185	3477	5873267	85.8228
3487	跡部	アトベ	184	3487	5873451	85.8255
3488	安	アン	184	3487	5873635	85.8282
3489	上島	ウエシマ	184	3487	5873819	85.8309
3490	浦上	ウラカミ	184	3487	5874003	85.8336
3491	小木	オギ	184	3487	5874187	85.8363
3492	衣笠	キヌガサ	184	3487	5874371	85.839
3493	公文	クモン	184	3487	5874555	85.8416
3494	小枝	コエダ	184	3487	5874739	85.8443
3495	実方	サネカタ	184	3487	5874923	85.847
3496	諏佐	スサ	184	3487	5875107	85.8497
3497	額賀	ヌカガ	184	3487	5875291	85.8524
3498	萩尾	ハギオ	184	3487	5875475	85.8551
3499	弘中	ヒロナカ	184	3487	5875659	85.8578
3500	尾藤	ビトウ	184	3487	5875843	85.8605
3501	前畑	マエハタ	184	3487	5876027	85.8632
3502	森嶋	モリシマ	184	3487	5876211	85.8658
3503	柳町	ヤナギマチ	184	3487	5876395	85.8685
3504	新木	アラキ	183	3504	5876578	85.8712
3505	葛城	カツラギ	183	3504	5876761	85.8739
3506	金城	カナシロ	183	3504	5876944	85.8766
3507	粂	クメ	183	3504	5877127	85.8792
3508	小見	コミ	183	3504	5877310	85.8819
3509	三條	サンジヨウ	183	3504	5877493	85.8846
3510	渋江	シブエ	183	3504	5877676	85.8873
3511	野嶋	ノジマ	183	3504	5877859	85.8899
3512	藤曲	フジマガリ	183	3504	5878042	85.8926
3513	三枝	ミエダ	183	3504	5878225	85.8953
3514	安間	ヤスマ	183	3504	5878408	85.8979
3515	横塚	ヨコツカ	183	3504	5878591	85.9006
3516	粟飯原	アイハラ	182	3516	5878773	85.9033
3517	天川	アマカワ	182	3516	5878955	85.9059
3518	天笠	アマガサ	182	3516	5879137	85.9086
3519	家田	イエダ	182	3516	5879319	85.9113
3520	入内嶋	イリウチジマ	182	3516	5879501	85.9139
3521	大根田	オオネダ	182	3516	5879683	85.9166
3522	鹿嶋	カシマ	182	3516	5879865	85.9192
3523	国枝	クニエダ	182	3516	5880047	85.9219
3524	下平	シモヒラ	182	3516	5880229	85.9246
3525	榛葉	シンバ	182	3516	5880411	85.9272
3526	関矢	セキヤ	182	3516	5880593	85.9299
3527	永友	ナガトモ	182	3516	5880775	85.9325
3528	野宮	ノミヤ	182	3516	5880957	85.9352
3529	船水	フナミズ	182	3516	5881139	85.9379
3530	政木	マサキ	182	3516	5881321	85.9405
3531	丸野	マルノ	182	3516	5881503	85.9432
3532	三竹	ミタケ	182	3516	5881685	85.9458
3533	宮路	ミヤジ	182	3516	5881867	85.9485
3534	梁川	ヤナガワ	182	3516	5882049	85.9512
3535	梁瀬	ヤナセ	182	3516	5882231	85.9538
3536	岡戸	オカド	181	3536	5882412	85.9565
3537	鬼塚	オニツカ	181	3536	5882593	85.9591
3538	柏原	カシハラ	181	3536	5882774	85.9617
3539	嘉村	カムラ	181	3536	5882955	85.9644
3540	熊崎	クマザキ	181	3536	5883136	85.967
3541	建部	タテベ	181	3536	5883317	85.9697
3542	朝長	トモナガ	181	3536	5883498	85.9723
3543	中神	ナカガミ	181	3536	5883679	85.975
3544	橋野	ハシノ	181	3536	5883860	85.9776
3545	藤松	フジマツ	181	3536	5884041	85.9803
3546	間辺	マナベ	181	3536	5884222	85.9829
3547	薬袋	ミナイ	181	3536	5884403	85.9855
3548	三野	ミノ	181	3536	5884584	85.9882
3549	宮寺	ミヤデラ	181	3536	5884765	85.9908
3550	浅賀	アサカ	180	3550	5884945	85.9935
3551	朝野	アサノ	180	3550	5885125	85.9961
3552	荒谷	アラタニ	180	3550	5885305	85.9987
3553	有路	アリジ	180	3550	5885485	86.0014
3554	押山	オシヤマ	180	3550	5885665	86.004
3555	柏村	カシムラ	180	3550	5885845	86.0066
3556	剱持	ケンモツ	180	3550	5886025	86.0093
3557	鹿内	シカナイ	180	3550	5886205	86.0119
3558	鈴鹿	スズカ	180	3550	5886385	86.0145
3559	砂原	スナハラ	180	3550	5886565	86.0171
3560	瀧田	タキタ	180	3550	5886745	86.0198
3561	奈良岡	ナラオカ	180	3550	5886925	86.0224
3562	水橋	ミズハシ	180	3550	5887105	86.025
3563	青池	アオイケ	179	3563	5887284	86.0276
3564	入野	イリノ	179	3563	5887463	86.0303
3565	小野間	オノマ	179	3563	5887642	86.0329
3566	可児	カニ	179	3563	5887821	86.0355
3567	国友	クニトモ	179	3563	5888000	86.0381
3568	志摩	シマ	179	3563	5888179	86.0407
3569	白田	シロタ	179	3563	5888358	86.0433
3570	須佐	スサ	179	3563	5888537	86.046
3571	高澤	タカザワ	179	3563	5888716	86.0486
3572	高根	タカネ	179	3563	5888895	86.0512
3573	棚田	タナダ	179	3563	5889074	86.0538
3574	田平	タヒラ	179	3563	5889253	86.0564
3575	坪谷	ツボヤ	179	3563	5889432	86.059
3576	照沼	テルヌマ	179	3563	5889611	86.0617
3577	当麻	トウマ	179	3563	5889790	86.0643
3578	當山	トウヤマ	179	3563	5889969	86.0669
3579	仲戸川	ナカトガワ	179	3563	5890148	86.0695
3580	袴田	ハカマタ	179	3563	5890327	86.0721
3581	星谷	ホシヤ	179	3563	5890506	86.0747
3582	細見	ホソミ	179	3563	5890685	86.0773
3583	宇治	ウジ	178	3583	5890863	86.0799
3584	大道	オオミチ	178	3583	5891041	86.0825
3585	柏田	カシワダ	178	3583	5891219	86.0851
3586	鎌形	カマガタ	178	3583	5891397	86.0877
3587	小園	コゾノ	178	3583	5891575	86.0903
3588	呉屋	ゴヤ	178	3583	5891753	86.093
3589	財津	ザイツ	178	3583	5891931	86.0956
3590	篠木	シノキ	178	3583	5892109	86.0982
3591	杉内	スギウチ	178	3583	5892287	86.1008
3592	田頭	タガシラ	178	3583	5892465	86.1034
3593	名嘉	ナカ	178	3583	5892643	86.106
3594	日向野	ヒガノ	178	3583	5892821	86.1086
3595	町野	マチノ	178	3583	5892999	86.1112
3596	宮西	ミヤニシ	178	3583	5893177	86.1138
3597	森澤	モリサワ	178	3583	5893355	86.1164
3598	八幡	ヤワタ	178	3583	5893533	86.119
3599	和地	ワチ	178	3583	5893711	86.1216
3600	秋澤	アキザワ	177	3600	5893888	86.1241
3601	有働	ウドウ	177	3600	5894065	86.1267
3602	江崎	エサキ	177	3600	5894242	86.1293
3603	長部	オサベ	177	3600	5894419	86.1319
3604	尾高	オダカ	177	3600	5894596	86.1345
3605	国島	クニシマ	177	3600	5894773	86.1371
3606	小濱	コハマ	177	3600	5894950	86.1397
3607	駒沢	コマザワ	177	3600	5895127	86.1423
3608	菰田	コモダ	177	3600	5895304	86.1448
3609	菅生	スゴウ	177	3600	5895481	86.1474
3610	高萩	タカハギ	177	3600	5895658	86.15
3611	大胡	ダイゴ	177	3600	5895835	86.1526
3612	月村	ツキムラ	177	3600	5896012	86.1552
3613	成宮	ナルミヤ	177	3600	5896189	86.1578
3614	西海	ニシガイ	177	3600	5896366	86.1604
3615	野津	ノヅ	177	3600	5896543	86.1629
3616	濱中	ハマナカ	177	3600	5896720	86.1655
3617	板東	バンドウ	177	3600	5896897	86.1681
3618	久富	ヒサトミ	177	3600	5897074	86.1707
3619	藤塚	フジツカ	177	3600	5897251	86.1733
3620	干場	ホシバ	177	3600	5897428	86.1759
3621	三戸	ミト	177	3600	5897605	86.1785
3622	源	ミナモト	177	3600	5897782	86.181
3623	谷戸	ヤト	177	3600	5897959	86.1836
3624	荒瀬	アラセ	176	3624	5898135	86.1862
3625	有野	アリノ	176	3624	5898311	86.1888
3626	石郷岡	イシゴウオカ	176	3624	5898487	86.1914
3627	犬山	イヌヤマ	176	3624	5898663	86.1939
3628	浦井	ウライ	176	3624	5898839	86.1965
3629	江端	エバタ	176	3624	5899015	86.1991
3630	大日向	オオヒナタ	176	3624	5899191	86.2016
3631	金岡	カナオカ	176	3624	5899367	86.2042
3632	貴田	キダ	176	3624	5899543	86.2068
3633	仙石	センゴク	176	3624	5899719	86.2094
3634	田尾	タオ	176	3624	5899895	86.2119
3635	近田	チカダ	176	3624	5900071	86.2145
3636	中臣	ナカトミ	176	3624	5900247	86.2171
3637	檜垣	ヒガキ	176	3624	5900423	86.2196
3638	比企	ヒキ	176	3624	5900599	86.2222
3639	星名	ホシナ	176	3624	5900775	86.2248
3640	三瓶	ミカメ	176	3624	5900951	86.2274
3641	蓑輪	ミノワ	176	3624	5901127	86.2299
3642	森谷	モリタニ	176	3624	5901303	86.2325
3643	守山	モリヤマ	176	3624	5901479	86.2351
3644	安島	アジマ	175	3644	5901654	86.2376
3645	阿比留	アビル	175	3644	5901829	86.2402
3646	池川	イケガワ	175	3644	5902004	86.2427
3647	稲岡	イナオカ	175	3644	5902179	86.2453
3648	大上	オオガミ	175	3644	5902354	86.2479
3649	大羽	オオバ	175	3644	5902529	86.2504
3650	倉重	クラシゲ	175	3644	5902704	86.253
3651	古城	コジヨウ	175	3644	5902879	86.2555
3652	関島	セキジマ	175	3644	5903054	86.2581
3653	玉野	タマノ	175	3644	5903229	86.2606
3654	玉山	タマヤマ	175	3644	5903404	86.2632
3655	千坂	チサカ	175	3644	5903579	86.2658
3656	庭山	ニワヤマ	175	3644	5903754	86.2683
3657	花山	ハナヤマ	175	3644	5903929	86.2709
3658	本荘	ホンジヨウ	175	3644	5904104	86.2734
3659	青戸	アオト	174	3659	5904278	86.276
3660	天沼	アマヌマ	174	3659	5904452	86.2785
3661	大松	オオマツ	174	3659	5904626	86.2811
3662	小川名	オガワナ	174	3659	5904800	86.2836
3663	貴島	キジマ	174	3659	5904974	86.2861
3664	五島	ゴシマ	174	3659	5905148	86.2887
3665	嶋野	シマノ	174	3659	5905322	86.2912
3666	谷沢	タニザワ	174	3659	5905496	86.2938
3667	出町	デマチ	174	3659	5905670	86.2963
3668	中倉	ナカクラ	174	3659	5905844	86.2989
3669	村澤	ムラサワ	174	3659	5906018	86.3014
3670	■澤	ヤナギサワ	174	3659	5906192	86.3039
3671	越	コシ	173	3671	5906365	86.3065
3672	永峯	ナガミネ	173	3671	5906538	86.309
3673	成沢	ナルサワ	173	3671	5906711	86.3115
3674	西巻	ニシマキ	173	3671	5906884	86.3141
3675	■方	ヒジカタ	173	3671	5907057	86.3166
3676	三山	ミヤマ	173	3671	5907230	86.3191
3677	青■	アオヤギ	172	3677	5907402	86.3216
3678	阿川	アガワ	172	3677	5907574	86.3241
3679	荒尾	アラオ	172	3677	5907746	86.3266
3680	鵜川	ウカワ	172	3677	5907918	86.3292
3681	大嶺	オオミネ	172	3677	5908090	86.3317
3682	金杉	カナスギ	172	3677	5908262	86.3342
3683	紙谷	カミヤ	172	3677	5908434	86.3367
3684	川勝	カワカツ	172	3677	5908606	86.3392
3685	新宅	シンタク	172	3677	5908778	86.3417
3686	■本	タカモト	172	3677	5908950	86.3442
3687	但野	タダノ	172	3677	5909122	86.3468
3688	太刀川	タチカワ	172	3677	5909294	86.3493
3689	千村	チムラ	172	3677	5909466	86.3518
3690	彦根	ヒコネ	172	3677	5909638	86.3543
3691	室谷	ムロヤ	172	3677	5909810	86.3568
3692	赤羽根	アカバネ	171	3692	5909981	86.3593
3693	穴井	アナイ	171	3692	5910152	86.3618
3694	内倉	ウチクラ	171	3692	5910323	86.3643
3695	大瀬	オオセ	171	3692	5910494	86.3668
3696	岸井	キシイ	171	3692	5910665	86.3693
3697	功刀	クヌギ	171	3692	5910836	86.3718
3698	是永	コレナガ	171	3692	5911007	86.3743
3699	阪井	サカイ	171	3692	5911178	86.3768
3700	酒川	サカガワ	171	3692	5911349	86.3793
3701	武野	タケノ	171	3692	5911520	86.3818
3702	武政	タケマサ	171	3692	5911691	86.3843
3703	千島	チシマ	171	3692	5911862	86.3868
3704	土岐	ドキ	171	3692	5912033	86.3893
3705	永津	ナガツ	171	3692	5912204	86.3918
3706	笛木	フエキ	171	3692	5912375	86.3943
3707	真間	ママ	171	3692	5912546	86.3968
3708	美濃部	ミノベ	171	3692	5912717	86.3993
3709	大嶽	オオタケ	170	3709	5912887	86.4018
3710	国松	クニマツ	170	3709	5913057	86.4043
3711	久原	クハラ	170	3709	5913227	86.4067
3712	新明	シンミヨウ	170	3709	5913397	86.4092
3713	善波	ゼンバ	170	3709	5913567	86.4117
3714	宋	ソウ	170	3709	5913737	86.4142
3715	竹前	タケマエ	170	3709	5913907	86.4167
3716	鶴谷	ツルヤ	170	3709	5914077	86.4192
3717	當間	トウマ	170	3709	5914247	86.4216
3718	長門	ナガト	170	3709	5914417	86.4241
3719	新見	ニイミ	170	3709	5914587	86.4266
3720	満田	ミツダ	170	3709	5914757	86.4291
3721	牛木	ウシキ	169	3721	5914926	86.4316
3722	内島	ウチジマ	169	3721	5915095	86.434
3723	刑部	オサカベ	169	3721	5915264	86.4365
3724	叶	カノウ	169	3721	5915433	86.439
3725	小塚	コツカ	169	3721	5915602	86.4414
3726	芝崎	シバサキ	169	3721	5915771	86.4439
3727	■桑	タカクワ	169	3721	5915940	86.4464
3728	棚原	タナハラ	169	3721	5916109	86.4489
3729	田場	タバ	169	3721	5916278	86.4513
3730	円谷	ツブラヤ	169	3721	5916447	86.4538
3731	速水	ハヤミズ	169	3721	5916616	86.4563
3732	増岡	マスオカ	169	3721	5916785	86.4587
3733	三根	ミネ	169	3721	5916954	86.4612
3734	箕浦	ミノウラ	169	3721	5917123	86.4637
3735	村元	ムラモト	169	3721	5917292	86.4661
3736	諸井	モロイ	169	3721	5917461	86.4686
3737	和栗	ワグリ	169	3721	5917630	86.4711
3738	赤崎	アカサキ	168	3738	5917798	86.4735
3739	飯原	イイハラ	168	3738	5917966	86.476
3740	池尻	イケジリ	168	3738	5918134	86.4784
3741	糸山	イトヤマ	168	3738	5918302	86.4809
3742	色川	イロカワ	168	3738	5918470	86.4834
3743	押見	オシミ	168	3738	5918638	86.4858
3744	小野原	オノハラ	168	3738	5918806	86.4883
3745	幸山	コウヤマ	168	3738	5918974	86.4907
3746	柴■	シバサキ	168	3738	5919142	86.4932
3747	鈴川	スズカワ	168	3738	5919310	86.4956
3748	多賀谷	タガヤ	168	3738	5919478	86.4981
3749	竹崎	タケザキ	168	3738	5919646	86.5005
3750	坪川	ツボカワ	168	3738	5919814	86.503
3751	引田	ヒキタ	168	3738	5919982	86.5054
3752	日野原	ヒノハラ	168	3738	5920150	86.5079
3753	堀籠	ホリゴメ	168	3738	5920318	86.5104
3754	真柄	マガラ	168	3738	5920486	86.5128
3755	松沼	マツヌマ	168	3738	5920654	86.5153
3756	吉浦	ヨシウラ	168	3738	5920822	86.5177
3757	稲場	イナバ	167	3757	5920989	86.5202
3758	鯉沼	コイヌマ	167	3757	5921156	86.5226
3759	澤山	サワヤマ	167	3757	5921323	86.525
3760	千木良	チギラ	167	3757	5921490	86.5275
3761	羽柴	ハシバ	167	3757	5921657	86.5299
3762	平泉	ヒライズミ	167	3757	5921824	86.5324
3763	舟田	フナダ	167	3757	5921991	86.5348
3764	諸節	モロフシ	167	3757	5922158	86.5372
3765	矢内	ヤウチ	167	3757	5922325	86.5397
3766	和気	ワキ	167	3757	5922492	86.5421
3767	秋間	アキマ	166	3767	5922658	86.5445
3768	井伊	イイ	166	3767	5922824	86.547
3769	伊吹	イブキ	166	3767	5922990	86.5494
3770	入口	イリグチ	166	3767	5923156	86.5518
3771	大桃	オオモモ	166	3767	5923322	86.5543
3772	草川	クサカワ	166	3767	5923488	86.5567
3773	是枝	コレエダ	166	3767	5923654	86.5591
3774	瀬戸山	セトヤマ	166	3767	5923820	86.5615
3775	鷹取	タカトリ	166	3767	5923986	86.564
3776	知花	チバナ	166	3767	5924152	86.5664
3777	花城	ハナシロ	166	3767	5924318	86.5688
3778	花見	ハナミ	166	3767	5924484	86.5712
3779	古正	フルシヨウ	166	3767	5924650	86.5737
3780	三崎	ミサキ	166	3767	5924816	86.5761
3781	八ツ橋	ヤツハシ	166	3767	5924982	86.5785
3782	石嶋	イシジマ	165	3782	5925147	86.5809
3783	乙部	オトベ	165	3782	5925312	86.5833
3784	蔵田	クラタ	165	3782	5925477	86.5857
3785	見目	ケンモク	165	3782	5925642	86.5882
3786	小崎	コザキ	165	3782	5925807	86.5906
3787	笹川	ササカワ	165	3782	5925972	86.593
3788	高階	タカシナ	165	3782	5926137	86.5954
3789	舘	タチ	165	3782	5926302	86.5978
3790	谷脇	タニワキ	165	3782	5926467	86.6002
3791	鶴野	ツルノ	165	3782	5926632	86.6026
3792	長岐	ナガキ	165	3782	5926797	86.605
3793	西元	ニシモト	165	3782	5926962	86.6074
3794	羽場	ハバ	165	3782	5927127	86.6099
3795	張替	ハリカエ	165	3782	5927292	86.6123
3796	牧嶋	マキシマ	165	3782	5927457	86.6147
3797	町井	マチイ	165	3782	5927622	86.6171
3798	御厨	ミクリヤ	165	3782	5927787	86.6195
3799	伊豆	イズ	164	3799	5927951	86.6219
3800	岩脇	イワワキ	164	3799	5928115	86.6243
3801	大地	オオチ	164	3799	5928279	86.6267
3802	尾川	オガワ	164	3799	5928443	86.6291
3803	小田部	オタベ	164	3799	5928607	86.6315
3804	姜	カン	164	3799	5928771	86.6339
3805	岸上	キシガミ	164	3799	5928935	86.6363
3806	近内	コンナイ	164	3799	5929099	86.6387
3807	白取	シラトリ	164	3799	5929263	86.6411
3808	末岡	スエオカ	164	3799	5929427	86.6435
3809	東城	トウジヨウ	164	3799	5929591	86.6459
3810	中嶌	ナカジマ	164	3799	5929755	86.6483
3811	中武	ナカタケ	164	3799	5929919	86.6506
3812	中町	ナカマチ	164	3799	5930083	86.653
3813	原子	ハラコ	164	3799	5930247	86.6554
3814	半谷	ハンガイ	164	3799	5930411	86.6578
3815	米良	メラ	164	3799	5930575	86.6602
3816	薮	ヤブ	164	3799	5930739	86.6626
3817	与儀	ヨギ	164	3799	5930903	86.665
3818	四元	ヨツモト	164	3799	5931067	86.6674
3819	藁谷	ワラガイ	164	3799	5931231	86.6698
3820	安部川	アベカワ	163	3820	5931394	86.6722
3821	伊坂	イサカ	163	3820	5931557	86.6746
3822	川路	カワジ	163	3820	5931720	86.677
3823	高野	コウノ	163	3820	5931883	86.6793
3824	小日向	コヒナタ	163	3820	5932046	86.6817
3825	権守	ゴンモリ	163	3820	5932209	86.6841
3826	境田	サカイダ	163	3820	5932372	86.6865
3827	田■	タサキ	163	3820	5932535	86.6889
3828	玉利	タマリ	163	3820	5932698	86.6913
3829	辻岡	ツジオカ	163	3820	5932861	86.6936
3830	穂苅	ホカリ	163	3820	5933024	86.696
3831	真弓	マユミ	163	3820	5933187	86.6984
3832	谷地	ヤチ	163	3820	5933350	86.7008
3833	阿久根	アクネ	162	3833	5933512	86.7032
3834	安保	アンポ	162	3833	5933674	86.7055
3835	生島	イクシマ	162	3833	5933836	86.7079
3836	石内	イシウチ	162	3833	5933998	86.7103
3837	磯川	イソカワ	162	3833	5934160	86.7126
3838	宇田川	ウタガワ	162	3833	5934322	86.715
3839	奥谷	オクヤ	162	3833	5934484	86.7174
3840	尾身	オミ	162	3833	5934646	86.7197
3841	篠宮	シノミヤ	162	3833	5934808	86.7221
3842	角田	スミダ	162	3833	5934970	86.7245
3843	竹越	タケコシ	162	3833	5935132	86.7268
3844	鳥谷部	トリヤベ	162	3833	5935294	86.7292
3845	畠中	ハタケナカ	162	3833	5935456	86.7316
3846	藤掛	フジカケ	162	3833	5935618	86.7339
3847	外園	ホカゾノ	162	3833	5935780	86.7363
3848	八子	ヤコ	162	3833	5935942	86.7387
3849	■川	ヤナガワ	162	3833	5936104	86.741
3850	浅海	アサウミ	161	3850	5936265	86.7434
3851	出縄	イデナワ	161	3850	5936426	86.7457
3852	江副	エゾエ	161	3850	5936587	86.7481
3853	上島	カミジマ	161	3850	5936748	86.7504
3854	刈谷	カリヤ	161	3850	5936909	86.7528
3855	釼持	ケンモチ	161	3850	5937070	86.7551
3856	末武	スエタケ	161	3850	5937231	86.7575
3857	土志田	トシダ	161	3850	5937392	86.7598
3858	村杉	ムラスギ	161	3850	5937553	86.7622
3859	浅賀	アサガ	160	3859	5937713	86.7645
3860	足利	アシカガ	160	3859	5937873	86.7669
3861	今枝	イマエダ	160	3859	5938033	86.7692
3862	大門	オオカド	160	3859	5938193	86.7716
3863	大辻	オオツジ	160	3859	5938353	86.7739
3864	金田	カナダ	160	3859	5938513	86.7762
3865	窪島	クボシマ	160	3859	5938673	86.7786
3866	神野	コウノ	160	3859	5938833	86.7809
3867	柴本	シバモト	160	3859	5938993	86.7832
3868	菅澤	スガサワ	160	3859	5939153	86.7856
3869	辰野	タツノ	160	3859	5939313	86.7879
3870	田部	タナベ	160	3859	5939473	86.7903
3871	戸辺	トベ	160	3859	5939633	86.7926
3872	中辻	ナカツジ	160	3859	5939793	86.7949
3873	沼井	ヌマイ	160	3859	5939953	86.7973
3874	沼沢	ヌマサワ	160	3859	5940113	86.7996
3875	日浦	ヒウラ	160	3859	5940273	86.8019
3876	米田	マイタ	160	3859	5940433	86.8043
3877	牧口	マキグチ	160	3859	5940593	86.8066
3878	溝江	ミゾエ	160	3859	5940753	86.809
3879	本川	モトカワ	160	3859	5940913	86.8113
3880	浅水	アサミズ	159	3880	5941072	86.8136
3881	安部	アンベ	159	3880	5941231	86.8159
3882	石尾	イシオ	159	3880	5941390	86.8183
3883	板坂	イタサカ	159	3880	5941549	86.8206
3884	榎並	エナミ	159	3880	5941708	86.8229
3885	大多和	オオタワ	159	3880	5941867	86.8252
3886	粕川	カスカワ	159	3880	5942026	86.8276
3887	金崎	カネザキ	159	3880	5942185	86.8299
3888	椛沢	カバサワ	159	3880	5942344	86.8322
3889	沓掛	クツカケ	159	3880	5942503	86.8345
3890	甲賀	コウガ	159	3880	5942662	86.8369
3891	迫田	サコタ	159	3880	5942821	86.8392
3892	澄川	スミカワ	159	3880	5942980	86.8415
3893	深石	フカイシ	159	3880	5943139	86.8438
3894	冨川	フカワ	159	3880	5943298	86.8461
3895	降旗	フリハタ	159	3880	5943457	86.8485
3896	真崎	マサキ	159	3880	5943616	86.8508
3897	森園	モリゾノ	159	3880	5943775	86.8531
3898	臼木	ウスキ	158	3898	5943933	86.8554
3899	金村	カネムラ	158	3898	5944091	86.8577
3900	萱野	カヤノ	158	3898	5944249	86.86
3901	仮屋	カリヤ	158	3898	5944407	86.8624
3902	木俣	キマタ	158	3898	5944565	86.8647
3903	姜	キヨウ	158	3898	5944723	86.867
3904	今田	コンタ	158	3898	5944881	86.8693
3905	笹倉	ササクラ	158	3898	5945039	86.8716
3906	築山	ツキヤマ	158	3898	5945197	86.8739
3907	敦賀	ツルガ	158	3898	5945355	86.8762
3908	徳植	トクウエ	158	3898	5945513	86.8785
3909	仲沢	ナカザワ	158	3898	5945671	86.8808
3910	東島	ヒガシジマ	158	3898	5945829	86.8831
3911	本名	ホンナ	158	3898	5945987	86.8854
3912	三塚	ミツヅカ	158	3898	5946145	86.8878
3913	三尋木	ミヒロギ	158	3898	5946303	86.8901
3914	与那覇	ヨナハ	158	3898	5946461	86.8924
3915	新	アタラシ	157	3915	5946618	86.8947
3916	井口	イノクチ	157	3915	5946775	86.897
3917	岡見	オカミ	157	3915	5946932	86.8993
3918	筧	カケイ	157	3915	5947089	86.9015
3919	加藤木	カトウギ	157	3915	5947246	86.9038
3920	草苅	クサカリ	157	3915	5947403	86.9061
3921	四戸	シノヘ	157	3915	5947560	86.9084
3922	舘岡	タテオカ	157	3915	5947717	86.9107
3923	寺口	テラグチ	157	3915	5947874	86.913
3924	仁平	ニヒラ	157	3915	5948031	86.9153
3925	福西	フクニシ	157	3915	5948188	86.9176
3926	古林	フルバヤシ	157	3915	5948345	86.9199
3927	堀場	ホリバ	157	3915	5948502	86.9222
3928	松戸	マツド	157	3915	5948659	86.9245
3929	丸本	マルモト	157	3915	5948816	86.9268
3930	茂手木	モテギ	157	3915	5948973	86.9291
3931	山戸	ヤマト	157	3915	5949130	86.9314
3932	横沢	ヨコサワ	157	3915	5949287	86.9337
3933	池谷	イケガヤ	156	3933	5949443	86.9359
3934	稲井	イナイ	156	3933	5949599	86.9382
3935	大園	オオゾノ	156	3933	5949755	86.9405
3936	大中	オオナカ	156	3933	5949911	86.9428
3937	海藤	カイドウ	156	3933	5950067	86.9451
3938	木川	キカワ	156	3933	5950223	86.9473
3939	魏	ギ	156	3933	5950379	86.9496
3940	濃沼	コイヌマ	156	3933	5950535	86.9519
3941	小長井	コナガイ	156	3933	5950691	86.9542
3942	小屋	コヤ	156	3933	5950847	86.9565
3943	後閑	ゴカン	156	3933	5951003	86.9587
3944	重村	シゲムラ	156	3933	5951159	86.961
3945	城山	シロヤマ	156	3933	5951315	86.9633
3946	曽根原	ソネハラ	156	3933	5951471	86.9656
3947	当間	トウマ	156	3933	5951627	86.9679
3948	戸崎	トザキ	156	3933	5951783	86.9701
3949	堂前	ドウマエ	156	3933	5951939	86.9724
3950	仲松	ナカマツ	156	3933	5952095	86.9747
3951	花房	ハナフサ	156	3933	5952251	86.977
3952	菱川	ヒシカワ	156	3933	5952407	86.9793
3953	美濃島	ミノシマ	156	3933	5952563	86.9815
3954	宮良	ミヤラ	156	3933	5952719	86.9838
3955	諸田	モロタ	156	3933	5952875	86.9861
3956	矢川	ヤガワ	156	3933	5953031	86.9884
3957	藪田	ヤブタ	156	3933	5953187	86.9907
3958	芦垣	アシガキ	155	3958	5953342	86.9929
3959	岩崎	イワザキ	155	3958	5953497	86.9952
3960	勝浦	カツウラ	155	3958	5953652	86.9974
3961	角	カド	155	3958	5953807	86.9997
3962	金指	カナサシ	155	3958	5953962	87.002
3963	萱沼	カヤヌマ	155	3958	5954117	87.0042
3964	川渕	カワブチ	155	3958	5954272	87.0065
3965	木立	キダチ	155	3958	5954427	87.0088
3966	越村	コシムラ	155	3958	5954582	87.011
3967	坂崎	サカザキ	155	3958	5954737	87.0133
3968	申	シン	155	3958	5954892	87.0156
3969	実川	ジツカワ	155	3958	5955047	87.0178
3970	菅野	スゲノ	155	3958	5955202	87.0201
3971	十河	ソゴウ	155	3958	5955357	87.0224
3972	■安	タカヤス	155	3958	5955512	87.0246
3973	徳本	トクモト	155	3958	5955667	87.0269
3974	冨沢	トミザワ	155	3958	5955822	87.0292
3975	中矢	ナカヤ	155	3958	5955977	87.0314
3976	橋川	ハシカワ	155	3958	5956132	87.0337
3977	原川	ハラカワ	155	3958	5956287	87.036
3978	平柳	ヒラヤナギ	155	3958	5956442	87.0382
3979	武川	ムカワ	155	3958	5956597	87.0405
3980	茂垣	モガキ	155	3958	5956752	87.0427
3981	飯澤	イイザワ	154	3981	5956906	87.045
3982	泉川	イズミカワ	154	3981	5957060	87.0472
3983	伊関	イセキ	154	3981	5957214	87.0495
3984	岩島	イワシマ	154	3981	5957368	87.0517
3985	瓜田	ウリタ	154	3981	5957522	87.054
3986	奥谷	オクタニ	154	3981	5957676	87.0562
3987	小宅	オヤケ	154	3981	5957830	87.0585
3988	小柳	オヤナギ	154	3981	5957984	87.0607
3989	角野	カクノ	154	3981	5958138	87.063
3990	栗木	クリキ	154	3981	5958292	87.0652
3991	里	サト	154	3981	5958446	87.0675
3992	椎橋	シイハシ	154	3981	5958600	87.0697
3993	志岐	シキ	154	3981	5958754	87.072
3994	茂野	シゲノ	154	3981	5958908	87.0742
3995	霜鳥	シモトリ	154	3981	5959062	87.0765
3996	住田	スミダ	154	3981	5959216	87.0788
3997	滝井	タキイ	154	3981	5959370	87.081
3998	常松	ツネマツ	154	3981	5959524	87.0833
3999	泊	トマリ	154	3981	5959678	87.0855
4000	新名	ニイナ	154	3981	5959832	87.0878
4001	貫井	ヌクイ	154	3981	5959986	87.09
4002	真下	マシタ	154	3981	5960140	87.0923
4003	八木田	ヤギタ	154	3981	5960294	87.0945
4004	八城	ヤシロ	154	3981	5960448	87.0968
4005	山ノ井	ヤマノイ	154	3981	5960602	87.099
4006	浦本	ウラモト	153	4006	5960755	87.1012
4007	生川	オイカワ	153	4006	5960908	87.1035
4008	金本	カナモト	153	4006	5961061	87.1057
4009	金野	キンノ	153	4006	5961214	87.1079
4010	玉手	タマテ	153	4006	5961367	87.1102
4011	千明	チギラ	153	4006	5961520	87.1124
4012	茶木	チヤキ	153	4006	5961673	87.1147
4013	千代田	チヨダ	153	4006	5961826	87.1169
4014	寺嶋	テラジマ	153	4006	5961979	87.1191
4015	中浜	ナカハマ	153	4006	5962132	87.1214
4016	鳴島	ナルシマ	153	4006	5962285	87.1236
4017	柳橋	ヤナギバシ	153	4006	5962438	87.1258
4018	和内	ワウチ	153	4006	5962591	87.1281
4019	伊倉	イクラ	152	4019	5962743	87.1303
4020	池間	イケマ	152	4019	5962895	87.1325
4021	内間	ウチマ	152	4019	5963047	87.1347
4022	漆畑	ウルシバタ	152	4019	5963199	87.137
4023	坂爪	サカヅメ	152	4019	5963351	87.1392
4024	坂西	サカニシ	152	4019	5963503	87.1414
4025	谷野	タニノ	152	4019	5963655	87.1436
4026	中馬	チユウマ	152	4019	5963807	87.1458
4027	津曲	ツマガリ	152	4019	5963959	87.1481
4028	遠矢	トオヤ	152	4019	5964111	87.1503
4029	徳元	トクモト	152	4019	5964263	87.1525
4030	友成	トモナリ	152	4019	5964415	87.1547
4031	名川	ナガワ	152	4019	5964567	87.1569
4032	縄田	ナワタ	152	4019	5964719	87.1592
4033	古里	フルサト	152	4019	5964871	87.1614
4034	丸川	マルカワ	152	4019	5965023	87.1636
4035	御手洗	ミタライ	152	4019	5965175	87.1658
4036	目崎	メザキ	152	4019	5965327	87.168
4037	山道	ヤマミチ	152	4019	5965479	87.1703
4038	芳川	ヨシカワ	152	4019	5965631	87.1725
4039	若木	ワカキ	152	4019	5965783	87.1747
4040	稲吉	イナヨシ	151	4040	5965934	87.1769
4041	伊野	イノ	151	4040	5966085	87.1791
4042	越前	エチゼン	151	4040	5966236	87.1813
4043	江部	エベ	151	4040	5966387	87.1835
4044	大住	オオスミ	151	4040	5966538	87.1857
4045	桂川	カツラガワ	151	4040	5966689	87.1879
4046	上遠野	カトウノ	151	4040	5966840	87.1902
4047	上倉	カミクラ	151	4040	5966991	87.1924
4048	黒井	クロイ	151	4040	5967142	87.1946
4049	国府田	コウダ	151	4040	5967293	87.1968
4050	櫻庭	サクラバ	151	4040	5967444	87.199
4051	神藤	シンドウ	151	4040	5967595	87.2012
4052	武松	タケマツ	151	4040	5967746	87.2034
4053	徳光	トクミツ	151	4040	5967897	87.2056
4054	刀根	トネ	151	4040	5968048	87.2078
4055	堂園	ドウゾノ	151	4040	5968199	87.21
4056	浪岡	ナミオカ	151	4040	5968350	87.2122
4057	羽石	ハネイシ	151	4040	5968501	87.2144
4058	浜辺	ハマベ	151	4040	5968652	87.2166
4059	三ツ井	ミツイ	151	4040	5968803	87.2188
4060	小■	オダカ	150	4060	5968953	87.221
4061	翁長	オナガ	150	4060	5969103	87.2232
4062	楠木	クスノキ	150	4060	5969253	87.2254
4063	■原	クワハラ	150	4060	5969403	87.2276
4064	軍司	グンジ	150	4060	5969553	87.2298
4065	鯉渕	コイブチ	150	4060	5969703	87.232
4066	坂場	サカバ	150	4060	5969853	87.2342
4067	菅田	スゲタ	150	4060	5970003	87.2364
4068	出羽	デワ	150	4060	5970153	87.2386
4069	友松	トモマツ	150	4060	5970303	87.2408
4070	仲原	ナカハラ	150	4060	5970453	87.243
4071	根上	ネガミ	150	4060	5970603	87.2451
4072	平方	ヒラカタ	150	4060	5970753	87.2473
4073	村崎	ムラサキ	150	4060	5970903	87.2495
4074	横谷	ヨコヤ	150	4060	5971053	87.2517
4075	秋永	アキナガ	149	4075	5971202	87.2539
4076	甘糟	アマカス	149	4075	5971351	87.2561
4077	池島	イケジマ	149	4075	5971500	87.2582
4078	大越	オオゴシ	149	4075	5971649	87.2604
4079	金内	カネウチ	149	4075	5971798	87.2626
4080	清沢	キヨサワ	149	4075	5971947	87.2648
4081	駒木	コマキ	149	4075	5972096	87.267
4082	島谷	シマタニ	149	4075	5972245	87.2691
4083	薛	セツ	149	4075	5972394	87.2713
4084	富所	トミドコロ	149	4075	5972543	87.2735
4085	鳥沢	トリサワ	149	4075	5972692	87.2757
4086	仲手川	ナカテガワ	149	4075	5972841	87.2778
4087	橋立	ハシダテ	149	4075	5972990	87.28
4088	福室	フクムロ	149	4075	5973139	87.2822
4089	水川	ミズカワ	149	4075	5973288	87.2844
4090	安宅	アタカ	148	4090	5973436	87.2865
4091	池畑	イケハタ	148	4090	5973584	87.2887
4092	井崎	イザキ	148	4090	5973732	87.2909
4093	稲山	イナヤマ	148	4090	5973880	87.293
4094	鵜澤	ウザワ	148	4090	5974028	87.2952
4095	尾池	オイケ	148	4090	5974176	87.2974
4096	奥秋	オクアキ	148	4090	5974324	87.2995
4097	監物	ケンモツ	148	4090	5974472	87.3017
4098	五嶋	ゴシマ	148	4090	5974620	87.3038
4099	作間	サクマ	148	4090	5974768	87.306
4100	須長	スナガ	148	4090	5974916	87.3082
4101	友永	トモナガ	148	4090	5975064	87.3103
4102	蜷川	ニナガワ	148	4090	5975212	87.3125
4103	沼口	ヌマグチ	148	4090	5975360	87.3147
4104	花房	ハナブサ	148	4090	5975508	87.3168
4105	針谷	ハリヤ	148	4090	5975656	87.319
4106	比佐	ヒサ	148	4090	5975804	87.3211
4107	増澤	マスザワ	148	4090	5975952	87.3233
4108	峰松	ミネマツ	148	4090	5976100	87.3255
4109	元井	モトイ	148	4090	5976248	87.3276
4110	八尾	ヤオ	148	4090	5976396	87.3298
4111	小見	オミ	147	4111	5976543	87.3319
4112	蔵並	クラナミ	147	4111	5976690	87.3341
4113	沢崎	サワザキ	147	4111	5976837	87.3362
4114	島川	シマカワ	147	4111	5976984	87.3384
4115	嶋貫	シマヌキ	147	4111	5977131	87.3405
4116	徳武	トクタケ	147	4111	5977278	87.3427
4117	中越	ナカゴシ	147	4111	5977425	87.3448
4118	野添	ノゾエ	147	4111	5977572	87.347
4119	福田	フクタ	147	4111	5977719	87.3491
4120	二川	フタガワ	147	4111	5977866	87.3513
4121	三科	ミシナ	147	4111	5978013	87.3534
4122	溝部	ミゾベ	147	4111	5978160	87.3556
4123	宮地	ミヤヂ	147	4111	5978307	87.3577
4124	矢■	ヤザキ	147	4111	5978454	87.3599
4125	山畑	ヤマハタ	147	4111	5978601	87.362
4126	■崎	ヨシザキ	147	4111	5978748	87.3642
4127	出雲	イズモ	146	4127	5978894	87.3663
4128	礒野	イソノ	146	4127	5979040	87.3684
4129	今本	イマモト	146	4127	5979186	87.3706
4130	薄	ウスキ	146	4127	5979332	87.3727
4131	蟹江	カニエ	146	4127	5979478	87.3748
4132	喜田	キダ	146	4127	5979624	87.377
4133	黒島	クロシマ	146	4127	5979770	87.3791
4134	■野	コウノ	146	4127	5979916	87.3812
4135	鴻巣	コウノス	146	4127	5980062	87.3834
4136	木幡	コワタ	146	4127	5980208	87.3855
4137	四條	シジヨウ	146	4127	5980354	87.3876
4138	二木	ニキ	146	4127	5980500	87.3898
4139	西中	ニシナカ	146	4127	5980646	87.3919
4140	間	ハザマ	146	4127	5980792	87.394
4141	波多	ハタ	146	4127	5980938	87.3962
4142	畑山	ハタケヤマ	146	4127	5981084	87.3983
4143	船戸	フナト	146	4127	5981230	87.4004
4144	古館	フルダテ	146	4127	5981376	87.4026
4145	牧石	マキイシ	146	4127	5981522	87.4047
4146	三吉	ミヨシ	146	4127	5981668	87.4068
4147	谷亀	ヤガメ	146	4127	5981814	87.409
4148	力丸	リキマル	146	4127	5981960	87.4111
4149	牛込	ウシゴメ	145	4149	5982105	87.4132
4150	荻	オギ	145	4149	5982250	87.4153
4151	小酒部	オサカベ	145	4149	5982395	87.4175
4152	小野口	オノグチ	145	4149	5982540	87.4196
4153	風見	カザミ	145	4149	5982685	87.4217
4154	喜納	キナ	145	4149	5982830	87.4238
4155	古根村	コネムラ	145	4149	5982975	87.4259
4156	小谷田	コヤタ	145	4149	5983120	87.428
4157	酒田	サカタ	145	4149	5983265	87.4302
4158	桜沢	サクラザワ	145	4149	5983410	87.4323
4159	澤本	サワモト	145	4149	5983555	87.4344
4160	新見	シンミ	145	4149	5983700	87.4365
4161	末田	スエダ	145	4149	5983845	87.4386
4162	新堀	ニイボリ	145	4149	5983990	87.4408
4163	深堀	フカホリ	145	4149	5984135	87.4429
4164	藤吉	フジヨシ	145	4149	5984280	87.445
4165	保住	ホズミ	145	4149	5984425	87.4471
4166	溝井	ミゾイ	145	4149	5984570	87.4492
4167	■成	ヨシナリ	145	4149	5984715	87.4514
4168	阿蘇	アソ	144	4168	5984859	87.4535
4169	一宮	イチミヤ	144	4168	5985003	87.4556
4170	韓	カン	144	4168	5985147	87.4577
4171	北郷	キタゴウ	144	4168	5985291	87.4598
4172	桐ヶ谷	キリガヤ	144	4168	5985435	87.4619
4173	小金沢	コガネザワ	144	4168	5985579	87.464
4174	小寺	コテラ	144	4168	5985723	87.4661
4175	斎木	サイキ	144	4168	5985867	87.4682
4176	崎田	サキタ	144	4168	5986011	87.4703
4177	笹崎	ササザキ	144	4168	5986155	87.4724
4178	里吉	サトヨシ	144	4168	5986299	87.4745
4179	角野	スミノ	144	4168	5986443	87.4766
4180	芹川	セリカワ	144	4168	5986587	87.4787
4181	竹見	タケミ	144	4168	5986731	87.4808
4182	手塚	テツカ	144	4168	5986875	87.4829
4183	殿岡	トノオカ	144	4168	5987019	87.485
4184	仲澤	ナカザワ	144	4168	5987163	87.4871
4185	永富	ナガトミ	144	4168	5987307	87.4892
4186	春名	ハルナ	144	4168	5987451	87.4913
4187	馬上	マガミ	144	4168	5987595	87.4934
4188	屋良	ヤラ	144	4168	5987739	87.4955
4189	■浜	ヨシハマ	144	4168	5987883	87.4976
4190	芳村	ヨシムラ	144	4168	5988027	87.4997
4191	網倉	アミクラ	143	4191	5988170	87.5018
4192	有我	アリガ	143	4191	5988313	87.5039
4193	池口	イケグチ	143	4191	5988456	87.506
4194	織裳	オリモ	143	4191	5988599	87.5081
4195	梶ヶ谷	カジガヤ	143	4191	5988742	87.5102
4196	木全	キマタ	143	4191	5988885	87.5123
4197	九鬼	クキ	143	4191	5989028	87.5144
4198	作本	サクモト	143	4191	5989171	87.5165
4199	椎原	シイハラ	143	4191	5989314	87.5186
4200	白砂	シラスナ	143	4191	5989457	87.5206
4201	新貝	シンカイ	143	4191	5989600	87.5227
4202	滝島	タキシマ	143	4191	5989743	87.5248
4203	竹生	タケオ	143	4191	5989886	87.5269
4204	田	デン	143	4191	5990029	87.529
4205	苫米地	トマベチ	143	4191	5990172	87.5311
4206	成岡	ナルオカ	143	4191	5990315	87.5332
4207	英	ハナブサ	143	4191	5990458	87.5353
4208	三橋	ミハシ	143	4191	5990601	87.5374
4209	村島	ムラシマ	143	4191	5990744	87.5395
4210	相羽	アイバ	142	4210	5990886	87.5415
4211	尼野	アマノ	142	4210	5991028	87.5436
4212	池山	イケヤマ	142	4210	5991170	87.5457
4213	石口	イシグチ	142	4210	5991312	87.5478
4214	伊地知	イヂチ	142	4210	5991454	87.5498
4215	歌田	ウタダ	142	4210	5991596	87.5519
4216	宇津木	ウツキ	142	4210	5991738	87.554
4217	鵜野	ウノ	142	4210	5991880	87.5561
4218	尾本	オモト	142	4210	5992022	87.5581
4219	樫山	カシヤマ	142	4210	5992164	87.5602
4220	香西	コウザイ	142	4210	5992306	87.5623
4221	小橋	コハシ	142	4210	5992448	87.5644
4222	執行	シギヨウ	142	4210	5992590	87.5664
4223	重信	シゲノブ	142	4210	5992732	87.5685
4224	峠	トウゲ	142	4210	5992874	87.5706
4225	長縄	ナガナワ	142	4210	5993016	87.5727
4226	長森	ナガモリ	142	4210	5993158	87.5747
4227	二本柳	ニホンヤナギ	142	4210	5993300	87.5768
4228	箱田	ハコダ	142	4210	5993442	87.5789
4229	帆足	ホアシ	142	4210	5993584	87.581
4230	松石	マツイシ	142	4210	5993726	87.583
4231	水元	ミズモト	142	4210	5993868	87.5851
4232	嶺岸	ミネギシ	142	4210	5994010	87.5872
4233	矢藤	ヤトウ	142	4210	5994152	87.5893
4234	米持	ヨネモチ	142	4210	5994294	87.5913
4235	和光	ワコウ	142	4210	5994436	87.5934
4236	藍原	アイハラ	141	4236	5994577	87.5955
4237	朝岡	アサオカ	141	4236	5994718	87.5975
4238	大館	オオダテ	141	4236	5994859	87.5996
4239	大家	オオヤ	141	4236	5995000	87.6016
4240	橘内	キツナイ	141	4236	5995141	87.6037
4241	古口	コグチ	141	4236	5995282	87.6058
4242	世良	セラ	141	4236	5995423	87.6078
4243	千賀	センガ	141	4236	5995564	87.6099
4244	竹元	タケモト	141	4236	5995705	87.6119
4245	中野渡	ナカノワタリ	141	4236	5995846	87.614
4246	永久保	ナガクボ	141	4236	5995987	87.6161
4247	成毛	ナルケ	141	4236	5996128	87.6181
4248	濱崎	ハマサキ	141	4236	5996269	87.6202
4249	比護	ヒゴ	141	4236	5996410	87.6222
4250	細江	ホソエ	141	4236	5996551	87.6243
4251	三冨	ミトミ	141	4236	5996692	87.6264
4252	桃原	モモハラ	141	4236	5996833	87.6284
4253	由良	ユラ	141	4236	5996974	87.6305
4254	渡貫	ワタヌキ	141	4236	5997115	87.6325
4255	縣	アガタ	140	4255	5997255	87.6346
4256	茨木	イバラギ	140	4255	5997395	87.6366
4257	鵜沼	ウヌマ	140	4255	5997535	87.6387
4258	大曲	オオマガリ	140	4255	5997675	87.6407
4259	鍛治	カジ	140	4255	5997815	87.6428
4260	梶谷	カジヤ	140	4255	5997955	87.6448
4261	鹿山	カヤマ	140	4255	5998095	87.6469
4262	衣川	キヌガワ	140	4255	5998235	87.6489
4263	久下	クゲ	140	4255	5998375	87.651
4264	沓澤	クツザワ	140	4255	5998515	87.653
4265	五明	ゴミヨウ	140	4255	5998655	87.6551
4266	佐俣	サマタ	140	4255	5998795	87.6571
4267	三田	サンダ	140	4255	5998935	87.6591
4268	柴■	シバザキ	140	4255	5999075	87.6612
4269	神宮司	ジングウジ	140	4255	5999215	87.6632
4270	■■	タカヤナギ	140	4255	5999355	87.6653
4271	崔	チエ	140	4255	5999495	87.6673
4272	當麻	トウマ	140	4255	5999635	87.6694
4273	西畑	ニシハタ	140	4255	5999775	87.6714
4274	沼	ヌマ	140	4255	5999915	87.6735
4275	晴山	ハレヤマ	140	4255	6000055	87.6755
4276	前島	マエシマ	140	4255	6000195	87.6776
4277	三國	ミクニ	140	4255	6000335	87.6796
4278	三坂	ミサカ	140	4255	6000475	87.6816
4279	村林	ムラバヤシ	140	4255	6000615	87.6837
4280	粟飯原	アワイハラ	139	4280	6000754	87.6857
4281	江里口	エリグチ	139	4280	6000893	87.6878
4282	大上	オオウエ	139	4280	6001032	87.6898
4283	大渕	オオフチ	139	4280	6001171	87.6918
4284	金原	キンパラ	139	4280	6001310	87.6938
4285	重原	シゲハラ	139	4280	6001449	87.6959
4286	島内	シマウチ	139	4280	6001588	87.6979
4287	下坂	シモサカ	139	4280	6001727	87.6999
4288	白子	シラコ	139	4280	6001866	87.702
4289	樋田	トイダ	139	4280	6002005	87.704
4290	富松	トミマツ	139	4280	6002144	87.706
4291	中坪	ナカツボ	139	4280	6002283	87.7081
4292	西平	ニシヒラ	139	4280	6002422	87.7101
4293	早津	ハヤツ	139	4280	6002561	87.7121
4294	古見	フルミ	139	4280	6002700	87.7142
4295	眞壁	マカベ	139	4280	6002839	87.7162
4296	溝上	ミゾカミ	139	4280	6002978	87.7182
4297	赤岩	アカイワ	138	4297	6003116	87.7202
4298	天谷	アマヤ	138	4297	6003254	87.7223
4299	卜部	ウラベ	138	4297	6003392	87.7243
4300	江戸	エド	138	4297	6003530	87.7263
4301	奥住	オクズミ	138	4297	6003668	87.7283
4302	長	オサ	138	4297	6003806	87.7303
4303	織田	オリタ	138	4297	6003944	87.7323
4304	喜屋武	キヤン	138	4297	6004082	87.7344
4305	九島	クシマ	138	4297	6004220	87.7364
4306	窪倉	クボクラ	138	4297	6004358	87.7384
4307	坂尾	サカオ	138	4297	6004496	87.7404
4308	滝上	タキガミ	138	4297	6004634	87.7424
4309	鄭	チヨン	138	4297	6004772	87.7444
4310	富沢	トミサワ	138	4297	6004910	87.7465
4311	中川原	ナカガワラ	138	4297	6005048	87.7485
4312	乗田	ノリタ	138	4297	6005186	87.7505
4313	船見	フナミ	138	4297	6005324	87.7525
4314	桝本	マスモト	138	4297	6005462	87.7545
4315	水内	ミズウチ	138	4297	6005600	87.7565
4316	森町	モリマチ	138	4297	6005738	87.7586
4317	阿久沢	アクザワ	137	4317	6005875	87.7606
4318	五十畑	イソハタ	137	4317	6006012	87.7626
4319	今城	イマジヨウ	137	4317	6006149	87.7646
4320	大見	オオミ	137	4317	6006286	87.7666
4321	小笠原	オガサハラ	137	4317	6006423	87.7686
4322	小田嶋	オダシマ	137	4317	6006560	87.7706
4323	茅	カヤ	137	4317	6006697	87.7726
4324	柄澤	カラサワ	137	4317	6006834	87.7746
4325	熊川	クマカワ	137	4317	6006971	87.7766
4326	倉知	クラチ	137	4317	6007108	87.7786
4327	小中	コナカ	137	4317	6007245	87.7806
4328	下原	シモハラ	137	4317	6007382	87.7826
4329	武原	タケハラ	137	4317	6007519	87.7846
4330	常見	ツネミ	137	4317	6007656	87.7866
4331	羽深	ハブカ	137	4317	6007793	87.7886
4332	林崎	ハヤシザキ	137	4317	6007930	87.7906
4333	日景	ヒカゲ	137	4317	6008067	87.7926
4334	藤生	フジウ	137	4317	6008204	87.7946
4335	三堀	ミホリ	137	4317	6008341	87.7966
4336	元吉	モトヨシ	137	4317	6008478	87.7986
4337	吉越	ヨシコシ	137	4317	6008615	87.8006
4338	若命	ワカメ	137	4317	6008752	87.8026
4339	秋津	アキツ	136	4339	6008888	87.8046
4340	石飛	イシトビ	136	4339	6009024	87.8066
4341	榎木	エノキ	136	4339	6009160	87.8086
4342	鴨井	カモイ	136	4339	6009296	87.8105
4343	久貝	クガイ	136	4339	6009432	87.8125
4344	熊山	クマヤマ	136	4339	6009568	87.8145
4345	桑畑	クワハタ	136	4339	6009704	87.8165
4346	古座野	コザノ	136	4339	6009840	87.8185
4347	坂川	サカガワ	136	4339	6009976	87.8205
4348	崎原	サキハラ	136	4339	6010112	87.8225
4349	椙山	スギヤマ	136	4339	6010248	87.8245
4350	竹谷	タケタニ	136	4339	6010384	87.8264
4351	帖佐	チヨウサ	136	4339	6010520	87.8284
4352	戸叶	トカノ	136	4339	6010656	87.8304
4353	坂	バン	136	4339	6010792	87.8324
4354	広部	ヒロベ	136	4339	6010928	87.8344
4355	藤丸	フジマル	136	4339	6011064	87.8364
4356	真山	マヤマ	136	4339	6011200	87.8384
4357	湯口	ユグチ	136	4339	6011336	87.8404
4358	生野	イクノ	135	4358	6011471	87.8423
4359	梅宮	ウメミヤ	135	4358	6011606	87.8443
4360	沖村	オキムラ	135	4358	6011741	87.8463
4361	小笹	オザサ	135	4358	6011876	87.8482
4362	鬼沢	オニザワ	135	4358	6012011	87.8502
4363	神沢	カンザワ	135	4358	6012146	87.8522
4364	菊谷	キクヤ	135	4358	6012281	87.8542
4365	牛頭	ゴズ	135	4358	6012416	87.8561
4366	佐多	サタ	135	4358	6012551	87.8581
4367	重山	シゲヤマ	135	4358	6012686	87.8601
4368	田添	タゾエ	135	4358	6012821	87.8621
4369	恒川	ツネカワ	135	4358	6012956	87.864
4370	弦巻	ツルマキ	135	4358	6013091	87.866
4371	長戸	ナガト	135	4358	6013226	87.868
4372	行木	ナメキ	135	4358	6013361	87.8699
4373	福川	フクカワ	135	4358	6013496	87.8719
4374	星田	ホシダ	135	4358	6013631	87.8739
4375	光山	ミツヤマ	135	4358	6013766	87.8759
4376	森部	モリベ	135	4358	6013901	87.8778
4377	諸石	モロイシ	135	4358	6014036	87.8798
4378	赤岡	アカオカ	134	4378	6014170	87.8818
4379	阿野	アノ	134	4378	6014304	87.8837
4380	伊与田	イヨダ	134	4378	6014438	87.8857
4381	上保	ウワボ	134	4378	6014572	87.8876
4382	越後谷	エチゴヤ	134	4378	6014706	87.8896
4383	小野木	オノギ	134	4378	6014840	87.8916
4384	甲斐田	カイダ	134	4378	6014974	87.8935
4385	嘉数	カカズ	134	4378	6015108	87.8955
4386	北崎	キタザキ	134	4378	6015242	87.8974
4387	楠元	クスモト	134	4378	6015376	87.8994
4388	桑村	クワムラ	134	4378	6015510	87.9013
4389	纐纈	コウケツ	134	4378	6015644	87.9033
4390	薦田	コモダ	134	4378	6015778	87.9053
4391	重久	シゲヒサ	134	4378	6015912	87.9072
4392	地引	ジビキ	134	4378	6016046	87.9092
4393	■坂	タカサカ	134	4378	6016180	87.9111
4394	立田	タツタ	134	4378	6016314	87.9131
4395	館野	タテノ	134	4378	6016448	87.9151
4396	浜松	ハママツ	134	4378	6016582	87.917
4397	船本	フナモト	134	4378	6016716	87.919
4398	古河	フルカワ	134	4378	6016850	87.9209
4399	外間	ホカマ	134	4378	6016984	87.9229
4400	三杉	ミスギ	134	4378	6017118	87.9248
4401	宮谷	ミヤタニ	134	4378	6017252	87.9268
4402	迎	ムカエ	134	4378	6017386	87.9288
4403	朝井	アサイ	133	4403	6017519	87.9307
4404	石阪	イシザカ	133	4403	6017652	87.9326
4405	翁川	オイカワ	133	4403	6017785	87.9346
4406	海沼	カイヌマ	133	4403	6017918	87.9365
4407	金目	カナメ	133	4403	6018051	87.9385
4408	笹村	ササムラ	133	4403	6018184	87.9404
4409	篠沢	シノザワ	133	4403	6018317	87.9424
4410	篠塚	シノツカ	133	4403	6018450	87.9443
4411	情野	セイノ	133	4403	6018583	87.9462
4412	高取	タカトリ	133	4403	6018716	87.9482
4413	田本	タモト	133	4403	6018849	87.9501
4414	遠田	トオダ	133	4403	6018982	87.9521
4415	中泉	ナカイズミ	133	4403	6019115	87.954
4416	永渕	ナガフチ	133	4403	6019248	87.956
4417	二梃木	ニチヨウギ	133	4403	6019381	87.9579
4418	浜谷	ハマヤ	133	4403	6019514	87.9599
4419	早崎	ハヤサキ	133	4403	6019647	87.9618
4420	丸谷	マルタニ	133	4403	6019780	87.9637
4421	水野谷	ミズノヤ	133	4403	6019913	87.9657
4422	出井	イデイ	132	4422	6020045	87.9676
4423	大濱	オオハマ	132	4422	6020177	87.9695
4424	川津	カワツ	132	4422	6020309	87.9715
4425	菊村	キクムラ	132	4422	6020441	87.9734
4426	九嶋	クシマ	132	4422	6020573	87.9753
4427	桑島	クワシマ	132	4422	6020705	87.9773
4428	小井土	コイド	132	4422	6020837	87.9792
4429	塩原	シオハラ	132	4422	6020969	87.9811
4430	下山田	シモヤマダ	132	4422	6021101	87.983
4431	高下	タカシタ	132	4422	6021233	87.985
4432	田島	タシマ	132	4422	6021365	87.9869
4433	樽井	タルイ	132	4422	6021497	87.9888
4434	辻川	ツジカワ	132	4422	6021629	87.9908
4435	露崎	ツユザキ	132	4422	6021761	87.9927
4436	白田	ハクタ	132	4422	6021893	87.9946
4437	久本	ヒサモト	132	4422	6022025	87.9965
4438	藤盛	フジモリ	132	4422	6022157	87.9985
4439	堀込	ホリゴメ	132	4422	6022289	88.0004
4440	升水	マスミズ	132	4422	6022421	88.0023
4441	町	マチ	132	4422	6022553	88.0043
4442	美馬	ミマ	132	4422	6022685	88.0062
4443	葉	ヨウ	132	4422	6022817	88.0081
4444	粟田	アワタ	131	4444	6022948	88.01
4445	飯塚	イイツカ	131	4444	6023079	88.0119
4446	井元	イモト	131	4444	6023210	88.0139
4447	梅津	ウメズ	131	4444	6023341	88.0158
4448	奥沢	オクザワ	131	4444	6023472	88.0177
4449	小崎	オザキ	131	4444	6023603	88.0196
4450	勝本	カツモト	131	4444	6023734	88.0215
4451	鹿又	カノマタ	131	4444	6023865	88.0234
4452	蕪木	カブラギ	131	4444	6023996	88.0253
4453	倉嶋	クラシマ	131	4444	6024127	88.0273
4454	剣持	ケンモツ	131	4444	6024258	88.0292
4455	古俣	コマタ	131	4444	6024389	88.0311
4456	米谷	コメタニ	131	4444	6024520	88.033
4457	五反田	ゴタンダ	131	4444	6024651	88.0349
4458	齋田	サイタ	131	4444	6024782	88.0368
4459	島根	シマネ	131	4444	6024913	88.0387
4460	下里	シモサト	131	4444	6025044	88.0407
4461	高間	タカマ	131	4444	6025175	88.0426
4462	藤	トウ	131	4444	6025306	88.0445
4463	二木	フタツギ	131	4444	6025437	88.0464
4464	牧瀬	マキセ	131	4444	6025568	88.0483
4465	三栖	ミス	131	4444	6025699	88.0502
4466	三和	ミワ	131	4444	6025830	88.0521
4467	目代	モクダイ	131	4444	6025961	88.0541
4468	■田	ヤナギダ	131	4444	6026092	88.056
4469	山北	ヤマキタ	131	4444	6026223	88.0579
4470	吉■	ヨシザキ	131	4444	6026354	88.0598
4471	秋田谷	アキタヤ	130	4471	6026484	88.0617
4472	安生	アンジヨウ	130	4471	6026614	88.0636
4473	礒崎	イソザキ	130	4471	6026744	88.0655
4474	今坂	イマサカ	130	4471	6026874	88.0674
4475	浦辺	ウラベ	130	4471	6027004	88.0693
4476	大菊	オオギク	130	4471	6027134	88.0712
4477	大重	オオシゲ	130	4471	6027264	88.0731
4478	柏倉	カシクラ	130	4471	6027394	88.075
4479	加地	カジ	130	4471	6027524	88.0769
4480	加治屋	カジヤ	130	4471	6027654	88.0788
4481	鯨岡	クジラオカ	130	4471	6027784	88.0807
4482	駒崎	コマザキ	130	4471	6027914	88.0826
4483	駒野	コマノ	130	4471	6028044	88.0845
4484	五嶋	ゴトウ	130	4471	6028174	88.0864
4485	柴垣	シバガキ	130	4471	6028304	88.0883
4486	園山	ソノヤマ	130	4471	6028434	88.0902
4487	田草川	タクサガワ	130	4471	6028564	88.0921
4488	戸高	トダカ	130	4471	6028694	88.094
4489	富安	トミヤス	130	4471	6028824	88.0959
4490	豊村	トヨムラ	130	4471	6028954	88.0978
4491	八谷	ハチヤ	130	4471	6029084	88.0997
4492	原嶋	ハラシマ	130	4471	6029214	88.1016
4493	普川	フカワ	130	4471	6029344	88.1035
4494	麓	フモト	130	4471	6029474	88.1054
4495	御園生	ミソノウ	130	4471	6029604	88.1073
4496	森尾	モリオ	130	4471	6029734	88.1092
4497	山手	ヤマテ	130	4471	6029864	88.1111
4498	山藤	ヤマフジ	130	4471	6029994	88.113
4499	王	ワン	130	4471	6030124	88.1149
4500	後田	ウシロダ	129	4500	6030253	88.1168
4501	打田	ウチダ	129	4500	6030382	88.1187
4502	梅林	ウメバヤシ	129	4500	6030511	88.1205
4503	折井	オリイ	129	4500	6030640	88.1224
4504	加古	カコ	129	4500	6030769	88.1243
4505	鏑木	カブラキ	129	4500	6030898	88.1262
4506	菊本	キクモト	129	4500	6031027	88.1281
4507	倉光	クラミツ	129	4500	6031156	88.13
4508	幸村	コウムラ	129	4500	6031285	88.1319
4509	嶋岡	シマオカ	129	4500	6031414	88.1337
4510	外川	ソトカワ	129	4500	6031543	88.1356
4511	高	タカ	129	4500	6031672	88.1375
4512	■沢	タカザワ	129	4500	6031801	88.1394
4513	但馬	タジマ	129	4500	6031930	88.1413
4514	田近	タヂカ	129	4500	6032059	88.1432
4515	豊崎	トヨサキ	129	4500	6032188	88.1451
4516	永盛	ナガモリ	129	4500	6032317	88.1469
4517	二神	フタガミ	129	4500	6032446	88.1488
4518	文屋	ブンヤ	129	4500	6032575	88.1507
4519	三重野	ミエノ	129	4500	6032704	88.1526
4520	山平	ヤマヒラ	129	4500	6032833	88.1545
4521	鷲田	ワシダ	129	4500	6032962	88.1564
4522	赤司	アカシ	128	4522	6033090	88.1582
4523	赤穂	アコウ	128	4522	6033218	88.1601
4524	一杉	イチスギ	128	4522	6033346	88.162
4525	井戸川	イドガワ	128	4522	6033474	88.1638
4526	稲木	イナキ	128	4522	6033602	88.1657
4527	押本	オシモト	128	4522	6033730	88.1676
4528	金輪	カナワ	128	4522	6033858	88.1695
4529	釜田	カマタ	128	4522	6033986	88.1713
4530	国見	クニミ	128	4522	6034114	88.1732
4531	隈部	クマベ	128	4522	6034242	88.1751
4532	黒羽	クロハ	128	4522	6034370	88.1769
4533	小■	コタカ	128	4522	6034498	88.1788
4534	駒澤	コマザワ	128	4522	6034626	88.1807
4535	猿渡	サワタリ	128	4522	6034754	88.1825
4536	寺■	テラサキ	128	4522	6034882	88.1844
4537	徳竹	トクタケ	128	4522	6035010	88.1863
4538	幡谷	ハタヤ	128	4522	6035138	88.1882
4539	花方	ハナガタ	128	4522	6035266	88.19
4540	春川	ハルカワ	128	4522	6035394	88.1919
4541	福野	フクノ	128	4522	6035522	88.1938
4542	藤浪	フジナミ	128	4522	6035650	88.1956
4543	穂積	ホズミ	128	4522	6035778	88.1975
4544	堀岡	ホリオカ	128	4522	6035906	88.1994
4545	槇田	マキタ	128	4522	6036034	88.2012
4546	牧村	マキムラ	128	4522	6036162	88.2031
4547	丸子	マルコ	128	4522	6036290	88.205
4548	光武	ミツタケ	128	4522	6036418	88.2069
4549	安松	ヤスマツ	128	4522	6036546	88.2087
4550	脇谷	ワキヤ	128	4522	6036674	88.2106
4551	分部	ワケベ	128	4522	6036802	88.2125
4552	赤星	アカボシ	127	4552	6036929	88.2143
4553	穴田	アナダ	127	4552	6037056	88.2162
4554	嵐	アラシ	127	4552	6037183	88.218
4555	鵜殿	ウドノ	127	4552	6037310	88.2199
4556	江守	エモリ	127	4552	6037437	88.2218
4557	大黒	オオグロ	127	4552	6037564	88.2236
4558	門	カド	127	4552	6037691	88.2255
4559	金川	カネカワ	127	4552	6037818	88.2273
4560	上出	カミデ	127	4552	6037945	88.2292
4561	川原田	カワハラダ	127	4552	6038072	88.231
4562	木寺	キデラ	127	4552	6038199	88.2329
4563	木所	キドコロ	127	4552	6038326	88.2347
4564	儀間	ギマ	127	4552	6038453	88.2366
4565	塩井	シオイ	127	4552	6038580	88.2385
4566	地主	ジヌシ	127	4552	6038707	88.2403
4567	角津	ツノヅ	127	4552	6038834	88.2422
4568	戸丸	トマル	127	4552	6038961	88.244
4569	浪川	ナミカワ	127	4552	6039088	88.2459
4570	奈良橋	ナラハシ	127	4552	6039215	88.2477
4571	南場	ナンバ	127	4552	6039342	88.2496
4572	引間	ヒキマ	127	4552	6039469	88.2514
4573	伏木	フシキ	127	4552	6039596	88.2533
4574	舩木	フナキ	127	4552	6039723	88.2552
4575	細沼	ホソヌマ	127	4552	6039850	88.257
4576	三室	ミムロ	127	4552	6039977	88.2589
4577	和久	ワク	127	4552	6040104	88.2607
4578	在原	アリハラ	126	4578	6040230	88.2626
4579	池松	イケマツ	126	4578	6040356	88.2644
4580	河■	カワサキ	126	4578	6040482	88.2662
4581	杵渕	キネブチ	126	4578	6040608	88.2681
4582	京谷	キヨウヤ	126	4578	6040734	88.2699
4583	清藤	キヨフジ	126	4578	6040860	88.2718
4584	■刀	クヌギ	126	4578	6040986	88.2736
4585	桑江	クワエ	126	4578	6041112	88.2755
4586	小菅	コスガ	126	4578	6041238	88.2773
4587	斉	サイ	126	4578	6041364	88.2791
4588	立松	タテマツ	126	4578	6041490	88.281
4589	長堀	ナガホリ	126	4578	6041616	88.2828
4590	西河	ニシカワ	126	4578	6041742	88.2847
4591	萩	ハギ	126	4578	6041868	88.2865
4592	花野	ハナノ	126	4578	6041994	88.2883
4593	半谷	ハンヤ	126	4578	6042120	88.2902
4594	深江	フカエ	126	4578	6042246	88.292
4595	松見	マツミ	126	4578	6042372	88.2939
4596	三塚	ミツカ	126	4578	6042498	88.2957
4597	南出	ミナミデ	126	4578	6042624	88.2975
4598	山谷	ヤマタニ	126	4578	6042750	88.2994
4599	羅	ラ	126	4578	6042876	88.3012
4600	相田	アイタ	125	4600	6043001	88.3031
4601	有沢	アリサワ	125	4600	6043126	88.3049
4602	安倍	アンバイ	125	4600	6043251	88.3067
4603	市山	イチヤマ	125	4600	6043376	88.3085
4604	上岡	ウエオカ	125	4600	6043501	88.3104
4605	上木	ウエキ	125	4600	6043626	88.3122
4606	漆山	ウルシヤマ	125	4600	6043751	88.314
4607	大城	オオキ	125	4600	6043876	88.3158
4608	折戸	オリト	125	4600	6044001	88.3177
4609	鍵山	カギヤマ	125	4600	6044126	88.3195
4610	木澤	キザワ	125	4600	6044251	88.3213
4611	楠山	クスヤマ	125	4600	6044376	88.3231
4612	洪	コウ	125	4600	6044501	88.325
4613	小平	コヒラ	125	4600	6044626	88.3268
4614	坂詰	サカヅメ	125	4600	6044751	88.3286
4615	重光	シゲミツ	125	4600	6044876	88.3305
4616	小路	シヨウジ	125	4600	6045001	88.3323
4617	曹	ソウ	125	4600	6045126	88.3341
4618	宗田	ソウダ	125	4600	6045251	88.3359
4619	染川	ソメカワ	125	4600	6045376	88.3378
4620	竹腰	タケコシ	125	4600	6045501	88.3396
4621	玉那覇	タマナハ	125	4600	6045626	88.3414
4622	多和田	タワダ	125	4600	6045751	88.3432
4623	角川	ツノカワ	125	4600	6045876	88.3451
4624	坪根	ツボネ	125	4600	6046001	88.3469
4625	東野	トウノ	125	4600	6046126	88.3487
4626	夏苅	ナツカリ	125	4600	6046251	88.3505
4627	根元	ネモト	125	4600	6046376	88.3524
4628	初見	ハツミ	125	4600	6046501	88.3542
4629	宮元	ミヤモト	125	4600	6046626	88.356
4630	村谷	ムラタニ	125	4600	6046751	88.3579
4631	■山	ヨシヤマ	125	4600	6046876	88.3597
4632	池部	イケベ	124	4632	6047000	88.3615
4633	板山	イタヤマ	124	4632	6047124	88.3633
4634	一条	イチジヨウ	124	4632	6047248	88.3651
4635	上本	ウエモト	124	4632	6047372	88.3669
4636	宇留野	ウルノ	124	4632	6047496	88.3687
4637	尾嶋	オジマ	124	4632	6047620	88.3705
4638	勝沼	カツヌマ	124	4632	6047744	88.3724
4639	国広	クニヒロ	124	4632	6047868	88.3742
4640	進士	シンジ	124	4632	6047992	88.376
4641	染矢	ソメヤ	124	4632	6048116	88.3778
4642	田之上	タノウエ	124	4632	6048240	88.3796
4643	時任	トキトウ	124	4632	6048364	88.3814
4644	仲丸	ナカマル	124	4632	6048488	88.3832
4645	西木	ニシキ	124	4632	6048612	88.385
4646	沼野	ヌマノ	124	4632	6048736	88.3869
4647	萩本	ハギモト	124	4632	6048860	88.3887
4648	藤居	フジイ	124	4632	6048984	88.3905
4649	古島	フルシマ	124	4632	6049108	88.3923
4650	牧原	マキハラ	124	4632	6049232	88.3941
4651	松長	マツナガ	124	4632	6049356	88.3959
4652	薮内	ヤブウチ	124	4632	6049480	88.3977
4653	鎗田	ヤリタ	124	4632	6049604	88.3995
4654	米岡	ヨネオカ	124	4632	6049728	88.4014
4655	赤根	アカネ	123	4655	6049851	88.4031
4656	浅山	アサヤマ	123	4655	6049974	88.4049
4657	姉崎	アネザキ	123	4655	6050097	88.4067
4658	石戸谷	イシトヤ	123	4655	6050220	88.4085
4659	牛久保	ウシクボ	123	4655	6050343	88.4103
4660	卯月	ウヅキ	123	4655	6050466	88.4121
4661	海江田	カイエダ	123	4655	6050589	88.4139
4662	刈田	カリタ	123	4655	6050712	88.4157
4663	河本	コウモト	123	4655	6050835	88.4175
4664	捧	ササゲ	123	4655	6050958	88.4193
4665	白尾	シラオ	123	4655	6051081	88.4211
4666	関塚	セキヅカ	123	4655	6051204	88.4229
4667	早田	ソウダ	123	4655	6051327	88.4247
4668	竹鼻	タケハナ	123	4655	6051450	88.4265
4669	茅根	チノネ	123	4655	6051573	88.4283
4670	戸島	トシマ	123	4655	6051696	88.4301
4671	永峰	ナガミネ	123	4655	6051819	88.4319
4672	久恒	ヒサツネ	123	4655	6051942	88.4337
4673	光田	ミツダ	123	4655	6052065	88.4355
4674	屋敷	ヤシキ	123	4655	6052188	88.4373
4675	横坂	ヨコサカ	123	4655	6052311	88.4391
4676	米津	ヨネヅ	123	4655	6052434	88.4409
4677	四方田	ヨモダ	123	4655	6052557	88.4427
4678	相磯	アイソ	122	4678	6052679	88.4445
4679	市瀬	イチセ	122	4678	6052801	88.4463
4680	糸数	イトカズ	122	4678	6052923	88.448
4681	伊能	イノウ	122	4678	6053045	88.4498
4682	今中	イマナカ	122	4678	6053167	88.4516
4683	今宮	イマミヤ	122	4678	6053289	88.4534
4684	老川	オイカワ	122	4678	6053411	88.4552
4685	織本	オリモト	122	4678	6053533	88.457
4686	川出	カワデ	122	4678	6053655	88.4587
4687	小鷹	コタカ	122	4678	6053777	88.4605
4688	椎木	シイキ	122	4678	6053899	88.4623
4689	嶌田	シマダ	122	4678	6054021	88.4641
4690	白山	シラヤマ	122	4678	6054143	88.4659
4691	杉木	スギキ	122	4678	6054265	88.4676
4692	高江洲	タカエス	122	4678	6054387	88.4694
4693	谷垣	タニガキ	122	4678	6054509	88.4712
4694	土本	ツチモト	122	4678	6054631	88.473
4695	戸谷	トタニ	122	4678	6054753	88.4748
4696	仲亀	ナカガメ	122	4678	6054875	88.4766
4697	鍋谷	ナベヤ	122	4678	6054997	88.4783
4698	韮沢	ニラサワ	122	4678	6055119	88.4801
4699	配島	ハイジマ	122	4678	6055241	88.4819
4700	廣石	ヒロイシ	122	4678	6055363	88.4837
4701	松園	マツゾノ	122	4678	6055485	88.4855
4702	馬目	マノメ	122	4678	6055607	88.4873
4703	三井田	ミイダ	122	4678	6055729	88.489
4704	茂戸藤	モトフジ	122	4678	6055851	88.4908
4705	阿久澤	アクザワ	121	4705	6055972	88.4926
4706	粟屋	アワヤ	121	4705	6056093	88.4944
4707	磯谷	イソヤ	121	4705	6056214	88.4961
4708	牛久	ウシク	121	4705	6056335	88.4979
4709	大鹿	オオシカ	121	4705	6056456	88.4997
4710	奥島	オクシマ	121	4705	6056577	88.5014
4711	兒玉	コダマ	121	4705	6056698	88.5032
4712	古谷野	コヤノ	121	4705	6056819	88.505
4713	齋木	サイキ	121	4705	6056940	88.5067
4714	里村	サトムラ	121	4705	6057061	88.5085
4715	■垣	タカガキ	121	4705	6057182	88.5103
4716	丹澤	タンザワ	121	4705	6057303	88.512
4717	新居	ニイ	121	4705	6057424	88.5138
4718	原木	ハラキ	121	4705	6057545	88.5156
4719	樋浦	ヒウラ	121	4705	6057666	88.5173
4720	三部	ミツベ	121	4705	6057787	88.5191
4721	室屋	ムロヤ	121	4705	6057908	88.5209
4722	屋宜	ヤギ	121	4705	6058029	88.5227
4723	矢本	ヤモト	121	4705	6058150	88.5244
4724	柚木	ユギ	121	4705	6058271	88.5262
4725	弓田	ユミタ	121	4705	6058392	88.528
4726	有光	アリミツ	120	4726	6058512	88.5297
4727	石附	イシヅキ	120	4726	6058632	88.5315
4728	大柿	オオガキ	120	4726	6058752	88.5332
4729	大波	オオナミ	120	4726	6058872	88.535
4730	加倉井	カクライ	120	4726	6058992	88.5367
4731	上島	カミシマ	120	4726	6059112	88.5385
4732	蒲原	カモハラ	120	4726	6059232	88.5402
4733	辛島	カラシマ	120	4726	6059352	88.542
4734	苅田	カリタ	120	4726	6059472	88.5437
4735	京野	キヨウノ	120	4726	6059592	88.5455
4736	釘宮	クギミヤ	120	4726	6059712	88.5472
4737	倉谷	クラタニ	120	4726	6059832	88.549
4738	桑本	クワモト	120	4726	6059952	88.5508
4739	清藤	セイトウ	120	4726	6060072	88.5525
4740	積田	ツミタ	120	4726	6060192	88.5543
4741	野内	ノウチ	120	4726	6060312	88.556
4742	真部	マナベ	120	4726	6060432	88.5578
4743	南沢	ミナミサワ	120	4726	6060552	88.5595
4744	森安	モリヤス	120	4726	6060672	88.5613
4745	横川	ヨコガワ	120	4726	6060792	88.563
4746	綿谷	ワタヤ	120	4726	6060912	88.5648
4747	板津	イタツ	119	4747	6061031	88.5665
4748	今里	イマザト	119	4747	6061150	88.5683
4749	枝松	エダマツ	119	4747	6061269	88.57
4750	翁	オウ	119	4747	6061388	88.5717
4751	柿田	カキタ	119	4747	6061507	88.5735
4752	菊原	キクハラ	119	4747	6061626	88.5752
4753	木下	キシタ	119	4747	6061745	88.577
4754	小高	コタカ	119	4747	6061864	88.5787
4755	五藤	ゴトウ	119	4747	6061983	88.5804
4756	下園	シモゾノ	119	4747	6062102	88.5822
4757	下元	シモモト	119	4747	6062221	88.5839
4758	庄	シヨウ	119	4747	6062340	88.5856
4759	白濱	シラハマ	119	4747	6062459	88.5874
4760	城野	ジヨウノ	119	4747	6062578	88.5891
4761	瀬山	セヤマ	119	4747	6062697	88.5909
4762	立木	ツイキ	119	4747	6062816	88.5926
4763	徳島	トクシマ	119	4747	6062935	88.5943
4764	永坂	ナガサカ	119	4747	6063054	88.5961
4765	成澤	ナルサワ	119	4747	6063173	88.5978
4766	萩田	ハギタ	119	4747	6063292	88.5996
4767	花本	ハナモト	119	4747	6063411	88.6013
4768	福重	フクシゲ	119	4747	6063530	88.603
4769	真島	マシマ	119	4747	6063649	88.6048
4770	三瀬	ミセ	119	4747	6063768	88.6065
4771	谷澤	ヤザワ	119	4747	6063887	88.6083
4772	吉留	ヨシトメ	119	4747	6064006	88.61
4773	鷲頭	ワシズ	119	4747	6064125	88.6117
4774	鷲山	ワシヤマ	119	4747	6064244	88.6135
4775	伊地知	イジチ	118	4775	6064362	88.6152
4776	上島	ウエジマ	118	4775	6064480	88.6169
4777	江橋	エバシ	118	4775	6064598	88.6186
4778	川浦	カワウラ	118	4775	6064716	88.6204
4779	川副	カワゾエ	118	4775	6064834	88.6221
4780	清本	キヨモト	118	4775	6064952	88.6238
4781	黒木	クロギ	118	4775	6065070	88.6255
4782	坂牧	サカマキ	118	4775	6065188	88.6273
4783	白谷	シラタニ	118	4775	6065306	88.629
4784	白戸	シロト	118	4775	6065424	88.6307
4785	新明	シンメイ	118	4775	6065542	88.6324
4786	新家	シンヤ	118	4775	6065660	88.6342
4787	楯	タテ	118	4775	6065778	88.6359
4788	庭田	ニワタ	118	4775	6065896	88.6376
4789	早見	ハヤミ	118	4775	6066014	88.6393
4790	藤下	フジシタ	118	4775	6066132	88.6411
4791	馬	マ	118	4775	6066250	88.6428
4792	水戸部	ミトベ	118	4775	6066368	88.6445
4793	横塚	ヨコヅカ	118	4775	6066486	88.6462
4794	秋保	アキホ	117	4794	6066603	88.6479
4795	飛鳥井	アスカイ	117	4794	6066720	88.6496
4796	安中	アンナカ	117	4794	6066837	88.6514
4797	市場	イチバ	117	4794	6066954	88.6531
4798	指宿	イブスキ	117	4794	6067071	88.6548
4799	入谷	イリタニ	117	4794	6067188	88.6565
4800	笠木	カサギ	117	4794	6067305	88.6582
4801	鐘ケ江	カネガエ	117	4794	6067422	88.6599
4802	椛島	カバシマ	117	4794	6067539	88.6616
4803	朽木	クチキ	117	4794	6067656	88.6633
4804	倉方	クラカタ	117	4794	6067773	88.665
4805	見城	ケンジヨウ	117	4794	6067890	88.6667
4806	小助川	コスケガワ	117	4794	6068007	88.6685
4807	税所	サイシヨ	117	4794	6068124	88.6702
4808	崎浜	サキハマ	117	4794	6068241	88.6719
4809	沢本	サワモト	117	4794	6068358	88.6736
4810	沢谷	サワヤ	117	4794	6068475	88.6753
4811	塩月	シオツキ	117	4794	6068592	88.677
4812	城島	ジヨウジマ	117	4794	6068709	88.6787
4813	武下	タケシタ	117	4794	6068826	88.6804
4814	出井	デイ	117	4794	6068943	88.6821
4815	常田	トキタ	117	4794	6069060	88.6838
4816	中路	ナカジ	117	4794	6069177	88.6856
4817	降矢	フルヤ	117	4794	6069294	88.6873
4818	南山	ミナミヤマ	117	4794	6069411	88.689
4819	宮嵜	ミヤザキ	117	4794	6069528	88.6907
4820	室賀	ムロガ	117	4794	6069645	88.6924
4821	矢向	ヤコウ	117	4794	6069762	88.6941
4822	山沢	ヤマサワ	117	4794	6069879	88.6958
4823	麻野	アサノ	116	4823	6069995	88.6975
4824	岩戸	イワト	116	4823	6070111	88.6992
4825	円城寺	エンジヨウジ	116	4823	6070227	88.7009
4826	小国	オグニ	116	4823	6070343	88.7026
4827	加賀見	カガミ	116	4823	6070459	88.7043
4828	垣花	カキハナ	116	4823	6070575	88.706
4829	柏瀬	カシワセ	116	4823	6070691	88.7077
4830	黒河内	クロコウチ	116	4823	6070807	88.7094
4831	幸地	コウチ	116	4823	6070923	88.7111
4832	小海	コカイ	116	4823	6071039	88.7128
4833	後藤田	ゴトウダ	116	4823	6071155	88.7145
4834	渋田	シブタ	116	4823	6071271	88.7161
4835	下重	シモジユウ	116	4823	6071387	88.7178
4836	進	シン	116	4823	6071503	88.7195
4837	瀬古	セコ	116	4823	6071619	88.7212
4838	■澤	タカサワ	116	4823	6071735	88.7229
4839	高屋	タカヤ	116	4823	6071851	88.7246
4840	奈良谷	ナラヤ	116	4823	6071967	88.7263
4841	西江	ニシエ	116	4823	6072083	88.728
4842	波多江	ハタエ	116	4823	6072199	88.7297
4843	比企野	ヒキノ	116	4823	6072315	88.7314
4844	一杉	ヒトスギ	116	4823	6072431	88.7331
4845	深作	フカサク	116	4823	6072547	88.7348
4846	深水	フカミ	116	4823	6072663	88.7365
4847	眞鍋	マナベ	116	4823	6072779	88.7382
4848	森■	モリサキ	116	4823	6072895	88.7399
4849	矢作	ヤサク	116	4823	6073011	88.7416
4850	池浦	イケウラ	115	4850	6073126	88.7433
4851	大湊	オオミナト	115	4850	6073241	88.7449
4852	樺山	カバヤマ	115	4850	6073356	88.7466
4853	刈屋	カリヤ	115	4850	6073471	88.7483
4854	五井	ゴイ	115	4850	6073586	88.75
4855	塩山	シオヤマ	115	4850	6073701	88.7517
4856	白畑	シラハタ	115	4850	6073816	88.7533
4857	住本	スミモト	115	4850	6073931	88.755
4858	龍野	タツノ	115	4850	6074046	88.7567
4859	館山	タテヤマ	115	4850	6074161	88.7584
4860	樽見	タルミ	115	4850	6074276	88.7601
4861	恒松	ツネマツ	115	4850	6074391	88.7617
4862	鶴崎	ツルサキ	115	4850	6074506	88.7634
4863	戸口	トグチ	115	4850	6074621	88.7651
4864	渡久地	トグチ	115	4850	6074736	88.7668
4865	伴野	トモノ	115	4850	6074851	88.7685
4866	仲尾	ナカオ	115	4850	6074966	88.7701
4867	乗松	ノリマツ	115	4850	6075081	88.7718
4868	巻田	マキタ	115	4850	6075196	88.7735
4869	守本	モリモト	115	4850	6075311	88.7752
4870	山嵜	ヤマザキ	115	4850	6075426	88.7769
4871	芳沢	ヨシザワ	115	4850	6075541	88.7785
4872	青嶋	アオシマ	114	4872	6075655	88.7802
4873	熱海	アツミ	114	4872	6075769	88.7819
4874	石戸谷	イシドヤ	114	4872	6075883	88.7835
4875	薄葉	ウスバ	114	4872	6075997	88.7852
4876	江花	エバナ	114	4872	6076111	88.7869
4877	岸村	キシムラ	114	4872	6076225	88.7885
4878	霧生	キリユウ	114	4872	6076339	88.7902
4879	久保谷	クボヤ	114	4872	6076453	88.7919
4880	栗崎	クリサキ	114	4872	6076567	88.7935
4881	坂爪	サカツメ	114	4872	6076681	88.7952
4882	坂庭	サカニワ	114	4872	6076795	88.7969
4883	佐田	サタ	114	4872	6076909	88.7985
4884	重永	シゲナガ	114	4872	6077023	88.8002
4885	重本	シゲモト	114	4872	6077137	88.8019
4886	新	シン	114	4872	6077251	88.8035
4887	新地	シンチ	114	4872	6077365	88.8052
4888	末光	スエミツ	114	4872	6077479	88.8069
4889	蓼沼	タデヌマ	114	4872	6077593	88.8085
4890	出水	デミズ	114	4872	6077707	88.8102
4891	徳村	トクムラ	114	4872	6077821	88.8119
4892	十時	トトキ	114	4872	6077935	88.8135
4893	蓮田	ハスダ	114	4872	6078049	88.8152
4894	久末	ヒサスエ	114	4872	6078163	88.8169
4895	升田	マスダ	114	4872	6078277	88.8185
4896	増野	マスノ	114	4872	6078391	88.8202
4897	宮城	ミヤシロ	114	4872	6078505	88.8219
4898	室谷	ムロタニ	114	4872	6078619	88.8235
4899	森原	モリハラ	114	4872	6078733	88.8252
4900	矢上	ヤガミ	114	4872	6078847	88.8269
4901	義澤	ヨシザワ	114	4872	6078961	88.8285
4902	米井	ヨネイ	114	4872	6079075	88.8302
4903	赤堀	アカボリ	113	4903	6079188	88.8318
4904	礒	イソ	113	4903	6079301	88.8335
4905	井部	イベ	113	4903	6079414	88.8351
4906	臼倉	ウスクラ	113	4903	6079527	88.8368
4907	大河	オオカワ	113	4903	6079640	88.8384
4908	親川	オヤカワ	113	4903	6079753	88.8401
4909	樫原	カシハラ	113	4903	6079866	88.8417
4910	樫本	カシモト	113	4903	6079979	88.8434
4911	金内	カナウチ	113	4903	6080092	88.845
4912	菊井	キクイ	113	4903	6080205	88.8467
4913	国原	クニハラ	113	4903	6080318	88.8483
4914	黒江	クロエ	113	4903	6080431	88.85
4915	■	コウ	113	4903	6080544	88.8516
4916	小浦	コウラ	113	4903	6080657	88.8533
4917	鹿田	シカダ	113	4903	6080770	88.855
4918	鈴江	スズエ	113	4903	6080883	88.8566
4919	図師	ズシ	113	4903	6080996	88.8583
4920	高草木	タカクサキ	113	4903	6081109	88.8599
4921	竹之下	タケノシタ	113	4903	6081222	88.8616
4922	立野	タツノ	113	4903	6081335	88.8632
4923	建石	タテイシ	113	4903	6081448	88.8649
4924	大工原	ダイクハラ	113	4903	6081561	88.8665
4925	円谷	ツムラヤ	113	4903	6081674	88.8682
4926	鶴島	ツルシマ	113	4903	6081787	88.8698
4927	冨川	トミカワ	113	4903	6081900	88.8715
4928	豊泉	トヨイズミ	113	4903	6082013	88.8731
4929	鍋倉	ナベクラ	113	4903	6082126	88.8748
4930	新谷	ニイヤ	113	4903	6082239	88.8764
4931	畑井	ハタイ	113	4903	6082352	88.8781
4932	土生	ハブ	113	4903	6082465	88.8797
4933	茨田	バラダ	113	4903	6082578	88.8814
4934	洞口	ホラグチ	113	4903	6082691	88.883
4935	本澤	ホンザワ	113	4903	6082804	88.8847
4936	御子柴	ミコシバ	113	4903	6082917	88.8863
4937	宮浦	ミヤウラ	113	4903	6083030	88.888
4938	山里	ヤマザト	113	4903	6083143	88.8896
4939	吉橋	ヨシハシ	113	4903	6083256	88.8913
4940	鷲見	ワシミ	113	4903	6083369	88.8929
4941	有松	アリマツ	112	4941	6083481	88.8946
4942	今林	イマバヤシ	112	4941	6083593	88.8962
4943	上野山	ウエノヤマ	112	4941	6083705	88.8978
4944	江■	エザキ	112	4941	6083817	88.8995
4945	生出	オイデ	112	4941	6083929	88.9011
4946	金崎	カナザキ	112	4941	6084041	88.9027
4947	亀川	カメカワ	112	4941	6084153	88.9044
4948	倉井	クライ	112	4941	6084265	88.906
4949	黒河	クロカワ	112	4941	6084377	88.9077
4950	胡	コ	112	4941	6084489	88.9093
4951	古林	コバヤシ	112	4941	6084601	88.9109
4952	猿橋	サルハシ	112	4941	6084713	88.9126
4953	佐脇	サワキ	112	4941	6084825	88.9142
4954	葛籠貫	ツヅラヌキ	112	4941	6084937	88.9158
4955	栃原	トチハラ	112	4941	6085049	88.9175
4956	長津	ナガツ	112	4941	6085161	88.9191
4957	名塚	ナヅカ	112	4941	6085273	88.9208
4958	東川	ヒガシカワ	112	4941	6085385	88.9224
4959	南谷	ミナミタニ	112	4941	6085497	88.924
4960	森藤	モリトウ	112	4941	6085609	88.9257
4961	山澤	ヤマサワ	112	4941	6085721	88.9273
4962	養田	ヨウダ	112	4941	6085833	88.9289
4963	龍崎	リユウザキ	112	4941	6085945	88.9306
4964	和島	ワジマ	112	4941	6086057	88.9322
4965	枝村	エダムラ	111	4965	6086168	88.9338
4966	大野木	オオノギ	111	4965	6086279	88.9355
4967	筧	カケヒ	111	4965	6086390	88.9371
4968	狩谷	カリヤ	111	4965	6086501	88.9387
4969	川松	カワマツ	111	4965	6086612	88.9403
4970	木谷	キヤ	111	4965	6086723	88.9419
4971	栗村	クリムラ	111	4965	6086834	88.9436
4972	上月	コウヅキ	111	4965	6086945	88.9452
4973	小阪	コサカ	111	4965	6087056	88.9468
4974	小藤	コフジ	111	4965	6087167	88.9484
4975	四方	シカタ	111	4965	6087278	88.9501
4976	坪	ツボ	111	4965	6087389	88.9517
4977	寺久保	テラクボ	111	4965	6087500	88.9533
4978	天明	テンミヨウ	111	4965	6087611	88.9549
4979	仲地	ナカチ	111	4965	6087722	88.9565
4980	仲谷	ナカヤ	111	4965	6087833	88.9582
4981	根間	ネマ	111	4965	6087944	88.9598
4982	羽藤	ハトウ	111	4965	6088055	88.9614
4983	東原	ヒガシハラ	111	4965	6088166	88.963
4984	細渕	ホソブチ	111	4965	6088277	88.9646
4985	水町	ミズマチ	111	4965	6088388	88.9663
4986	三尾	ミツオ	111	4965	6088499	88.9679
4987	谷口	ヤグチ	111	4965	6088610	88.9695
4988	山	ヤマ	111	4965	6088721	88.9711
4989	吉倉	ヨシクラ	111	4965	6088832	88.9728
4990	飯室	イイムロ	110	4990	6088942	88.9744
4991	伊礼	イレイ	110	4990	6089052	88.976
4992	岩淵	イワブチ	110	4990	6089162	88.9776
4993	御調	オシラベ	110	4990	6089272	88.9792
4994	蔵野	クラノ	110	4990	6089382	88.9808
4995	越山	コシヤマ	110	4990	6089492	88.9824
4996	児山	コヤマ	110	4990	6089602	88.984
4997	七戸	シチノヘ	110	4990	6089712	88.9856
4998	下井	シモイ	110	4990	6089822	88.9872
4999	杉尾	スギオ	110	4990	6089932	88.9888
5000	瀬下	セシタ	110	4990	6090042	88.9904
5001	其田	ソノダ	110	4990	6090152	88.992
5002	高城	タカシロ	110	4990	6090262	88.9937
5003	財部	タカラベ	110	4990	6090372	88.9953
5004	徳井	トクイ	110	4990	6090482	88.9969
5005	外谷	トヤ	110	4990	6090592	88.9985
5006	仁田	ニツタ	110	4990	6090702	89.0001
5007	橋爪	ハシズメ	110	4990	6090812	89.0017
5008	平口	ヒラグチ	110	4990	6090922	89.0033
5009	廣江	ヒロエ	110	4990	6091032	89.0049
5010	藤中	フジナカ	110	4990	6091142	89.0065
5011	本堂	ホンドウ	110	4990	6091252	89.0081
5012	正井	マサイ	110	4990	6091362	89.0097
5013	本	モト	110	4990	6091472	89.0113
5014	本松	モトマツ	110	4990	6091582	89.0129
5015	諸角	モロズミ	110	4990	6091692	89.0145
5016	力武	リキタケ	110	4990	6091802	89.0162
5017	若槻	ワカツキ	110	4990	6091912	89.0178
5018	脇坂	ワキザカ	110	4990	6092022	89.0194
5019	輪島	ワジマ	110	4990	6092132	89.021
5020	會澤	アイザワ	109	5020	6092241	89.0226
5021	朝山	アサヤマ	109	5020	6092350	89.0242
5022	壱岐	イキ	109	5020	6092459	89.0258
5023	石和	イシワ	109	5020	6092568	89.0273
5024	伊庭	イバ	109	5020	6092677	89.0289
5025	織戸	オリト	109	5020	6092786	89.0305
5026	神子	カミコ	109	5020	6092895	89.0321
5027	鬼島	キジマ	109	5020	6093004	89.0337
5028	久保川	クボカワ	109	5020	6093113	89.0353
5029	黒野	クロノ	109	5020	6093222	89.0369
5030	塩瀬	シオセ	109	5020	6093331	89.0385
5031	城下	シロシタ	109	5020	6093440	89.0401
5032	角田	スミタ	109	5020	6093549	89.0417
5033	添野	ソエノ	109	5020	6093658	89.0433
5034	津崎	ツザキ	109	5020	6093767	89.0449
5035	土持	ツチモチ	109	5020	6093876	89.0465
5036	徳岡	トクオカ	109	5020	6093985	89.0481
5037	鳥巣	トリス	109	5020	6094094	89.0496
5038	中薗	ナカゾノ	109	5020	6094203	89.0512
5039	行川	ナメカワ	109	5020	6094312	89.0528
5040	西浜	ニシハマ	109	5020	6094421	89.0544
5041	平元	ヒラモト	109	5020	6094530	89.056
5042	星加	ホシカ	109	5020	6094639	89.0576
5043	前場	マエバ	109	5020	6094748	89.0592
5044	真坂	マサカ	109	5020	6094857	89.0608
5045	御嶽	ミタケ	109	5020	6094966	89.0624
5046	宗村	ムネムラ	109	5020	6095075	89.064
5047	茂川	モガワ	109	5020	6095184	89.0656
5048	山屋	ヤマヤ	109	5020	6095293	89.0672
5049	吉満	ヨシミツ	109	5020	6095402	89.0688
5050	笠	リユウ	109	5020	6095511	89.0704
5051	赤瀬	アカセ	108	5051	6095619	89.0719
5052	秋岡	アキオカ	108	5051	6095727	89.0735
5053	浅谷	アサヤ	108	5051	6095835	89.0751
5054	井汲	イクミ	108	5051	6095943	89.0767
5055	上園	ウエゾノ	108	5051	6096051	89.0782
5056	長村	オサムラ	108	5051	6096159	89.0798
5057	蒲	カバ	108	5051	6096267	89.0814
5058	河又	カワマタ	108	5051	6096375	89.083
5059	河原崎	カワラザキ	108	5051	6096483	89.0846
5060	北園	キタゾノ	108	5051	6096591	89.0861
5061	木林	キバヤシ	108	5051	6096699	89.0877
5062	久場	クバ	108	5051	6096807	89.0893
5063	畔柳	クロヤナギ	108	5051	6096915	89.0909
5064	古田島	コタジマ	108	5051	6097023	89.0924
5065	重岡	シゲオカ	108	5051	6097131	89.094
5066	嶋倉	シマクラ	108	5051	6097239	89.0956
5067	田窪	タクボ	108	5051	6097347	89.0972
5068	種子田	タネダ	108	5051	6097455	89.0988
5069	津嘉山	ツカヤマ	108	5051	6097563	89.1003
5070	椿山	ツバキヤマ	108	5051	6097671	89.1019
5071	二戸	ニト	108	5051	6097779	89.1035
5072	広石	ヒロイシ	108	5051	6097887	89.1051
5073	広江	ヒロエ	108	5051	6097995	89.1067
5074	福光	フクミツ	108	5051	6098103	89.1082
5075	三ツ木	ミツギ	108	5051	6098211	89.1098
5076	水口	ミナクチ	108	5051	6098319	89.1114
5077	諸伏	モロフシ	108	5051	6098427	89.113
5078	矢ヶ崎	ヤガサキ	108	5051	6098535	89.1145
5079	安河内	ヤスコウチ	108	5051	6098643	89.1161
5080	吉森	ヨシモリ	108	5051	6098751	89.1177
5081	萬	ヨロズ	108	5051	6098859	89.1193
5082	相内	アイウチ	107	5082	6098966	89.1208
5083	赤崎	アカザキ	107	5082	6099073	89.1224
5084	秋丸	アキマル	107	5082	6099180	89.124
5085	麻田	アサダ	107	5082	6099287	89.1255
5086	有木	アリキ	107	5082	6099394	89.1271
5087	牛嶋	ウシジマ	107	5082	6099501	89.1287
5088	大枝	オオエダ	107	5082	6099608	89.1302
5089	大神	オオガミ	107	5082	6099715	89.1318
5090	面川	オモカワ	107	5082	6099822	89.1333
5091	折橋	オリハシ	107	5082	6099929	89.1349
5092	柿木	カキノキ	107	5082	6100036	89.1365
5093	唐崎	カラサキ	107	5082	6100143	89.138
5094	河部	カワベ	107	5082	6100250	89.1396
5095	葛貫	クズヌキ	107	5082	6100357	89.1412
5096	信夫	シノブ	107	5082	6100464	89.1427
5097	陣野	ジンノ	107	5082	6100571	89.1443
5098	須江	スエ	107	5082	6100678	89.1459
5099	住谷	スミタニ	107	5082	6100785	89.1474
5100	轟木	トドロキ	107	5082	6100892	89.149
5101	鳥越	トリコシ	107	5082	6100999	89.1505
5102	中浦	ナカウラ	107	5082	6101106	89.1521
5103	中塩	ナカシオ	107	5082	6101213	89.1537
5104	中庭	ナカニワ	107	5082	6101320	89.1552
5105	永堀	ナガホリ	107	5082	6101427	89.1568
5106	藤池	フジイケ	107	5082	6101534	89.1584
5107	細島	ホソジマ	107	5082	6101641	89.1599
5108	巻島	マキシマ	107	5082	6101748	89.1615
5109	槇野	マキノ	107	5082	6101855	89.1631
5110	又■	マタヨシ	107	5082	6101962	89.1646
5111	道上	ミチガミ	107	5082	6102069	89.1662
5112	百田	モモタ	107	5082	6102176	89.1677
5113	山ノ内	ヤマノウチ	107	5082	6102283	89.1693
5114	有澤	アリサワ	106	5114	6102389	89.1709
5115	板野	イタノ	106	5114	6102495	89.1724
5116	一石	イチイシ	106	5114	6102601	89.174
5117	出田	イデタ	106	5114	6102707	89.1755
5118	稲生	イノウ	106	5114	6102813	89.1771
5119	内	ウチ	106	5114	6102919	89.1786
5120	鵜木	ウノキ	106	5114	6103025	89.1802
5121	大久	オオヒサ	106	5114	6103131	89.1817
5122	角井	カクイ	106	5114	6103237	89.1833
5123	金島	カネシマ	106	5114	6103343	89.1848
5124	鎌野	カマノ	106	5114	6103449	89.1863
5125	上石	カミイシ	106	5114	6103555	89.1879
5126	清瀬	キヨセ	106	5114	6103661	89.1894
5127	弦間	ゲンマ	106	5114	6103767	89.191
5128	酒本	サカモト	106	5114	6103873	89.1925
5129	笹部	ササベ	106	5114	6103979	89.1941
5130	佐保	サホ	106	5114	6104085	89.1956
5131	沢登	サワノボリ	106	5114	6104191	89.1972
5132	杉■	スギサキ	106	5114	6104297	89.1987
5133	高平	タカヒラ	106	5114	6104403	89.2003
5134	瀧川	タキカワ	106	5114	6104509	89.2018
5135	武宮	タケミヤ	106	5114	6104615	89.2034
5136	代田	ダイタ	106	5114	6104721	89.2049
5137	寺戸	テラド	106	5114	6104827	89.2065
5138	徳久	トクヒサ	106	5114	6104933	89.208
5139	堂本	ドウモト	106	5114	6105039	89.2096
5140	中俣	ナカマタ	106	5114	6105145	89.2111
5141	縄	ナワ	106	5114	6105251	89.2127
5142	新川	ニイカワ	106	5114	6105357	89.2142
5143	仁井田	ニイダ	106	5114	6105463	89.2158
5144	西上	ニシガミ	106	5114	6105569	89.2173
5145	温井	ヌクイ	106	5114	6105675	89.2189
5146	布目	ヌノメ	106	5114	6105781	89.2204
5147	八戸	ハチノヘ	106	5114	6105887	89.222
5148	日暮	ヒグレ	106	5114	6105993	89.2235
5149	菱木	ヒシキ	106	5114	6106099	89.2251
5150	平手	ヒラテ	106	5114	6106205	89.2266
5151	広崎	ヒロサキ	106	5114	6106311	89.2282
5152	弘田	ヒロタ	106	5114	6106417	89.2297
5153	藤橋	フジハシ	106	5114	6106523	89.2313
5154	舛田	マスダ	106	5114	6106629	89.2328
5155	又村	マタムラ	106	5114	6106735	89.2344
5156	真船	マフネ	106	5114	6106841	89.2359
5157	溝上	ミゾガミ	106	5114	6106947	89.2375
5158	三ツ橋	ミツハシ	106	5114	6107053	89.239
5159	物部	モノベ	106	5114	6107159	89.2406
5160	米谷	ヨネタニ	106	5114	6107265	89.2421
5161	陸	リク	106	5114	6107371	89.2437
5162	天羽	アマハ	105	5162	6107476	89.2452
5163	池ケ谷	イケガヤ	105	5162	6107581	89.2467
5164	木塚	キヅカ	105	5162	6107686	89.2483
5165	喜友名	キユナ	105	5162	6107791	89.2498
5166	粂川	クメカワ	105	5162	6107896	89.2513
5167	■原	クワバラ	105	5162	6108001	89.2529
5168	小城	コジヨウ	105	5162	6108106	89.2544
5169	桜本	サクラモト	105	5162	6108211	89.2559
5170	三部	サンベ	105	5162	6108316	89.2575
5171	霜村	シモムラ	105	5162	6108421	89.259
5172	妹尾	セオ	105	5162	6108526	89.2605
5173	染野	ソメノ	105	5162	6108631	89.2621
5174	近岡	チカオカ	105	5162	6108736	89.2636
5175	天間	テンマ	105	5162	6108841	89.2651
5176	中河	ナカガワ	105	5162	6108946	89.2667
5177	中北	ナカキタ	105	5162	6109051	89.2682
5178	西牟田	ニシムタ	105	5162	6109156	89.2697
5179	蓮尾	ハスオ	105	5162	6109261	89.2713
5180	花崎	ハナザキ	105	5162	6109366	89.2728
5181	渕脇	フチワキ	105	5162	6109471	89.2743
5182	堀木	ホリキ	105	5162	6109576	89.2759
5183	南野	ミナミノ	105	5162	6109681	89.2774
5184	山坂	ヤマサカ	105	5162	6109786	89.2789
5185	飛鳥田	アスカタ	104	5185	6109890	89.2805
5186	安保	アボ	104	5185	6109994	89.282
5187	井之上	イノウエ	104	5185	6110098	89.2835
5188	大北	オオキタ	104	5185	6110202	89.285
5189	方波見	カタバミ	104	5185	6110306	89.2865
5190	上口	カミグチ	104	5185	6110410	89.2881
5191	萱場	カヤバ	104	5185	6110514	89.2896
5192	木賀	キガ	104	5185	6110618	89.2911
5193	菊永	キクナガ	104	5185	6110722	89.2926
5194	菊野	キクノ	104	5185	6110826	89.2941
5195	込宮	コミヤ	104	5185	6110930	89.2957
5196	櫻木	サクラギ	104	5185	6111034	89.2972
5197	猿谷	サルヤ	104	5185	6111138	89.2987
5198	澤谷	サワヤ	104	5185	6111242	89.3002
5199	志藤	シトウ	104	5185	6111346	89.3017
5200	下鳥	シモトリ	104	5185	6111450	89.3033
5201	上甲	ジヨウコウ	104	5185	6111554	89.3048
5202	須釜	スガマ	104	5185	6111658	89.3063
5203	竹間	チクマ	104	5185	6111762	89.3078
5204	茶谷	チヤタニ	104	5185	6111866	89.3093
5205	張	チヤン	104	5185	6111970	89.3109
5206	土江	ツチエ	104	5185	6112074	89.3124
5207	椿原	ツバキハラ	104	5185	6112178	89.3139
5208	津留	ツル	104	5185	6112282	89.3154
5209	得能	トクノウ	104	5185	6112386	89.3169
5210	殿村	トノムラ	104	5185	6112490	89.3185
5211	任	ニン	104	5185	6112594	89.32
5212	吹田	フキタ	104	5185	6112698	89.3215
5213	藤戸	フジト	104	5185	6112802	89.323
5214	藤根	フジネ	104	5185	6112906	89.3245
5215	松屋	マツヤ	104	5185	6113010	89.3261
5216	三星	ミツボシ	104	5185	6113114	89.3276
5217	三本	ミツモト	104	5185	6113218	89.3291
5218	本岡	モトオカ	104	5185	6113322	89.3306
5219	屋比久	ヤビク	104	5185	6113426	89.3321
5220	■崎	リユウザキ	104	5185	6113530	89.3337
5221	宇都木	ウツギ	103	5221	6113633	89.3352
5222	海老	エビ	103	5221	6113736	89.3367
5223	蛯子	エビコ	103	5221	6113839	89.3382
5224	生出	オイズル	103	5221	6113942	89.3397
5225	奥泉	オクイズミ	103	5221	6114045	89.3412
5226	尾下	オシタ	103	5221	6114148	89.3427
5227	小田中	オダナカ	103	5221	6114251	89.3442
5228	小櫃	オビツ	103	5221	6114354	89.3457
5229	柿内	カキウチ	103	5221	6114457	89.3472
5230	柏■	カシワザキ	103	5221	6114560	89.3487
5231	勝間	カツマ	103	5221	6114663	89.3502
5232	兼重	カネシゲ	103	5221	6114766	89.3517
5233	川戸	カワド	103	5221	6114869	89.3532
5234	木ノ内	キノウチ	103	5221	6114972	89.3547
5235	桐田	キリタ	103	5221	6115075	89.3562
5236	久家	クゲ	103	5221	6115178	89.3577
5237	国田	クニタ	103	5221	6115281	89.3592
5238	小市	コイチ	103	5221	6115384	89.3607
5239	小熊	コグマ	103	5221	6115487	89.3623
5240	小曽根	コソネ	103	5221	6115590	89.3638
5241	坂木	サカキ	103	5221	6115693	89.3653
5242	薩田	サツタ	103	5221	6115796	89.3668
5243	新堂	シンドウ	103	5221	6115899	89.3683
5244	杉林	スギバヤシ	103	5221	6116002	89.3698
5245	征矢	ソヤ	103	5221	6116105	89.3713
5246	■階	タカシナ	103	5221	6116208	89.3728
5247	竹嶋	タケシマ	103	5221	6116311	89.3743
5248	谷中	タニナカ	103	5221	6116414	89.3758
5249	徳留	トクドメ	103	5221	6116517	89.3773
5250	戸■	トダカ	103	5221	6116620	89.3788
5251	百々	ドド	103	5221	6116723	89.3803
5252	中舘	ナカダテ	103	5221	6116826	89.3818
5253	羽太	ハブタ	103	5221	6116929	89.3833
5254	廣■	ヒロセ	103	5221	6117032	89.3848
5255	南澤	ミナミサワ	103	5221	6117135	89.3863
5256	森上	モリカミ	103	5221	6117238	89.3878
5257	相崎	アイザキ	102	5257	6117340	89.3893
5258	家永	イエナガ	102	5257	6117442	89.3908
5259	井島	イジマ	102	5257	6117544	89.3923
5260	稲嶺	イナミネ	102	5257	6117646	89.3938
5261	石見	イワミ	102	5257	6117748	89.3953
5262	老沼	オイヌマ	102	5257	6117850	89.3968
5263	大渡	オオワタリ	102	5257	6117952	89.3983
5264	小楠	オグス	102	5257	6118054	89.3998
5265	小平	オダイラ	102	5257	6118156	89.4013
5266	梶村	カジムラ	102	5257	6118258	89.4027
5267	金岡	カネオカ	102	5257	6118360	89.4042
5268	岸部	キシベ	102	5257	6118462	89.4057
5269	古瀬	コセ	102	5257	6118564	89.4072
5270	木庭	コバ	102	5257	6118666	89.4087
5271	笹子	ササゴ	102	5257	6118768	89.4102
5272	財前	ザイゼン	102	5257	6118870	89.4117
5273	斯波	シバ	102	5257	6118972	89.4132
5274	隅田	スミタ	102	5257	6119074	89.4147
5275	惣田	ソウダ	102	5257	6119176	89.4162
5276	高月	タカツキ	102	5257	6119278	89.4176
5277	武澤	タケザワ	102	5257	6119380	89.4191
5278	寺地	テラチ	102	5257	6119482	89.4206
5279	寺原	テラハラ	102	5257	6119584	89.4221
5280	都倉	トクラ	102	5257	6119686	89.4236
5281	富谷	トミヤ	102	5257	6119788	89.4251
5282	根津	ネズ	102	5257	6119890	89.4266
5283	韓	ハン	102	5257	6119992	89.4281
5284	福尾	フクオ	102	5257	6120094	89.4296
5285	藤牧	フジマキ	102	5257	6120196	89.4311
5286	船場	フナバ	102	5257	6120298	89.4326
5287	松延	マツノブ	102	5257	6120400	89.434
5288	真辺	マナベ	102	5257	6120502	89.4355
5289	丸木	マルキ	102	5257	6120604	89.437
5290	光安	ミツヤス	102	5257	6120706	89.4385
5291	向江	ムカエ	102	5257	6120808	89.44
5292	山ノ上	ヤマノウエ	102	5257	6120910	89.4415
5293	赤穂	アカホ	101	5293	6121011	89.443
5294	阿諏訪	アスワ	101	5293	6121112	89.4444
5295	朝生	アソウ	101	5293	6121213	89.4459
5296	出野	イデノ	101	5293	6121314	89.4474
5297	大鐘	オオガネ	101	5293	6121415	89.4489
5298	大栗	オオグリ	101	5293	6121516	89.4504
5299	大成	オオナリ	101	5293	6121617	89.4518
5300	小田原	オダハラ	101	5293	6121718	89.4533
5301	折本	オリモト	101	5293	6121819	89.4548
5302	笠倉	カサクラ	101	5293	6121920	89.4563
5303	壁谷	カベヤ	101	5293	6122021	89.4577
5304	橘田	キツダ	101	5293	6122122	89.4592
5305	木名瀬	キナセ	101	5293	6122223	89.4607
5306	木内	キノウチ	101	5293	6122324	89.4622
5307	小安	コヤス	101	5293	6122425	89.4636
5308	塩浦	シオウラ	101	5293	6122526	89.4651
5309	鹿間	シカマ	101	5293	6122627	89.4666
5310	七條	シチジヨウ	101	5293	6122728	89.4681
5311	田名網	タナアミ	101	5293	6122829	89.4695
5312	戸室	トムロ	101	5293	6122930	89.471
5313	仲谷	ナカタニ	101	5293	6123031	89.4725
5314	延原	ノブハラ	101	5293	6123132	89.474
5315	野山	ノヤマ	101	5293	6123233	89.4754
5316	花里	ハナザト	101	5293	6123334	89.4769
5317	花塚	ハナヅカ	101	5293	6123435	89.4784
5318	浜谷	ハマタニ	101	5293	6123536	89.4799
5319	疋田	ヒキダ	101	5293	6123637	89.4813
5320	平栗	ヒラグリ	101	5293	6123738	89.4828
5321	細木	ホソキ	101	5293	6123839	89.4843
5322	前園	マエゾノ	101	5293	6123940	89.4858
5323	水留	ミズトメ	101	5293	6124041	89.4872
5324	谷沢	ヤザワ	101	5293	6124142	89.4887
5325	吉留	ヨシドメ	101	5293	6124243	89.4902
5326	■見	ヨシミ	101	5293	6124344	89.4917
5327	米森	ヨネモリ	101	5293	6124445	89.4932
5328	龍	リユウ	101	5293	6124546	89.4946
5329	早稲田	ワセダ	101	5293	6124647	89.4961
5330	相内	アイナイ	100	5330	6124747	89.4976
5331	朝香	アサカ	100	5330	6124847	89.499
5332	家村	イエムラ	100	5330	6124947	89.5005
5333	石射	イシイ	100	5330	6125047	89.5019
5334	糸永	イトナガ	100	5330	6125147	89.5034
5335	今吉	イマヨシ	100	5330	6125247	89.5049
5336	岩坪	イワツボ	100	5330	6125347	89.5063
5337	岩森	イワモリ	100	5330	6125447	89.5078
5338	牛丸	ウシマル	100	5330	6125547	89.5093
5339	江見	エミ	100	5330	6125647	89.5107
5340	追川	オイカワ	100	5330	6125747	89.5122
5341	大湖	オオゴ	100	5330	6125847	89.5136
5342	大宅	オオヤ	100	5330	6125947	89.5151
5343	折居	オリイ	100	5330	6126047	89.5166
5344	河	カワ	100	5330	6126147	89.518
5345	亀卦川	キケガワ	100	5330	6126247	89.5195
5346	北風	キタカゼ	100	5330	6126347	89.5209
5347	国安	クニヤス	100	5330	6126447	89.5224
5348	栗島	クリシマ	100	5330	6126547	89.5239
5349	小瀧	コタキ	100	5330	6126647	89.5253
5350	許斐	コノミ	100	5330	6126747	89.5268
5351	古森	コモリ	100	5330	6126847	89.5283
5352	雫石	シズクイシ	100	5330	6126947	89.5297
5353	篠村	シノムラ	100	5330	6127047	89.5312
5354	下西	シモニシ	100	5330	6127147	89.5326
5355	白藤	シラフジ	100	5330	6127247	89.5341
5356	高岩	タカイワ	100	5330	6127347	89.5356
5357	田北	タキタ	100	5330	6127447	89.537
5358	田森	タモリ	100	5330	6127547	89.5385
5359	樽川	タルカワ	100	5330	6127647	89.5399
5360	水流	ツル	100	5330	6127747	89.5414
5361	鶴川	ツルカワ	100	5330	6127847	89.5429
5362	鶴丸	ツルマル	100	5330	6127947	89.5443
5363	寺林	テラバヤシ	100	5330	6128047	89.5458
5364	徳	トク	100	5330	6128147	89.5472
5365	橋浦	ハシウラ	100	5330	6128247	89.5487
5366	羽田	ハタ	100	5330	6128347	89.5502
5367	羽生	ハブ	100	5330	6128447	89.5516
5368	浜島	ハマジマ	100	5330	6128547	89.5531
5369	町山	マチヤマ	100	5330	6128647	89.5546
5370	森合	モリアイ	100	5330	6128747	89.556
5371	八木原	ヤギハラ	100	5330	6128847	89.5575
5372	藪内	ヤブウチ	100	5330	6128947	89.5589
5373	■池	ヨシイケ	100	5330	6129047	89.5604
5374	与安	ヨヤス	100	5330	6129147	89.5619
5375	和気	ワケ	100	5330	6129247	89.5633
5376	安立	アダチ	99	5376	6129346	89.5648
5377	荒山	アラヤマ	99	5376	6129445	89.5662
5378	市井	イチイ	99	5376	6129544	89.5677
5379	猪田	イノダ	99	5376	6129643	89.5691
5380	岩部	イワベ	99	5376	6129742	89.5706
5381	歌代	ウタシロ	99	5376	6129841	89.572
5382	江越	エゴシ	99	5376	6129940	89.5734
5383	大胡田	オオゴダ	99	5376	6130039	89.5749
5384	尾原	オハラ	99	5376	6130138	89.5763
5385	勝目	カツメ	99	5376	6130237	89.5778
5386	神岡	カミオカ	99	5376	6130336	89.5792
5387	上久保	カミクボ	99	5376	6130435	89.5807
5388	神野	カンノ	99	5376	6130534	89.5821
5389	高麗	コマ	99	5376	6130633	89.5836
5390	小又	コマタ	99	5376	6130732	89.585
5391	阪上	サカガミ	99	5376	6130831	89.5865
5392	■見澤	タカミザワ	99	5376	6130930	89.5879
5393	竹川	タケガワ	99	5376	6131029	89.5894
5394	舘田	タテダ	99	5376	6131128	89.5908
5395	立脇	タテワキ	99	5376	6131227	89.5923
5396	谷原	タニハラ	99	5376	6131326	89.5937
5397	玉石	タマイシ	99	5376	6131425	89.5951
5398	勅使河原	テシガワラ	99	5376	6131524	89.5966
5399	布村	ヌノムラ	99	5376	6131623	89.598
5400	納富	ノウトミ	99	5376	6131722	89.5995
5401	朴	バク	99	5376	6131821	89.6009
5402	藤ノ木	フジノキ	99	5376	6131920	89.6024
5403	光本	ミツモト	99	5376	6132019	89.6038
5404	三善	ミヨシ	99	5376	6132118	89.6053
5405	山家	ヤンベ	99	5376	6132217	89.6067
5406	湯尾	ユオ	99	5376	6132316	89.6082
5407	六本木	ロツポンギ	99	5376	6132415	89.6096
5408	若森	ワカモリ	99	5376	6132514	89.6111
5409	会田	アイタ	98	5409	6132612	89.6125
5410	浅海	アサミ	98	5409	6132710	89.6139
5411	穴山	アナヤマ	98	5409	6132808	89.6154
5412	天内	アマナイ	98	5409	6132906	89.6168
5413	粟津	アワヅ	98	5409	6133004	89.6182
5414	池戸	イケド	98	5409	6133102	89.6197
5415	井波	イナミ	98	5409	6133200	89.6211
5416	尾辻	オツジ	98	5409	6133298	89.6225
5417	加賀屋	カガヤ	98	5409	6133396	89.6239
5418	梶井	カジイ	98	5409	6133494	89.6254
5419	勝呂	カツロ	98	5409	6133592	89.6268
5420	神原	カミハラ	98	5409	6133690	89.6282
5421	川平	カワヒラ	98	5409	6133788	89.6297
5422	木南	キナミ	98	5409	6133886	89.6311
5423	葛岡	クズオカ	98	5409	6133984	89.6325
5424	幸坂	コウサカ	98	5409	6134082	89.634
5425	香坂	コウサカ	98	5409	6134180	89.6354
5426	小吹	コブキ	98	5409	6134278	89.6368
5427	小■	コヤナギ	98	5409	6134376	89.6383
5428	芝野	シバノ	98	5409	6134474	89.6397
5429	曽山	ソヤマ	98	5409	6134572	89.6411
5430	■間	タカマ	98	5409	6134670	89.6426
5431	竹部	タケベ	98	5409	6134768	89.644
5432	武元	タケモト	98	5409	6134866	89.6454
5433	為我井	タメガイ	98	5409	6134964	89.6469
5434	中安	ナカヤス	98	5409	6135062	89.6483
5435	柳楽	ナギラ	98	5409	6135160	89.6497
5436	成富	ナリトミ	98	5409	6135258	89.6512
5437	沼山	ヌマヤマ	98	5409	6135356	89.6526
5438	萩野谷	ハギノヤ	98	5409	6135454	89.654
5439	狭間	ハザマ	98	5409	6135552	89.6555
5440	花島	ハナジマ	98	5409	6135650	89.6569
5441	日■	ヒヨシ	98	5409	6135748	89.6583
5442	晝間	ヒルマ	98	5409	6135846	89.6597
5443	藤方	フジカタ	98	5409	6135944	89.6612
5444	二木	フタキ	98	5409	6136042	89.6626
5445	古堅	フルゲン	98	5409	6136140	89.664
5446	細貝	ホソカイ	98	5409	6136238	89.6655
5447	松坂	マツサカ	98	5409	6136336	89.6669
5448	鞠子	マリコ	98	5409	6136434	89.6683
5449	美濃	ミノ	98	5409	6136532	89.6698
5450	向田	ムコウダ	98	5409	6136630	89.6712
5451	物江	モノエ	98	5409	6136728	89.6726
5452	山神	ヤマガミ	98	5409	6136826	89.6741
5453	山之井	ヤマノイ	98	5409	6136924	89.6755
5454	飯草	イイグサ	97	5454	6137021	89.6769
5455	伊澤	イサワ	97	5454	6137118	89.6783
5456	市成	イチナリ	97	5454	6137215	89.6798
5457	宇根	ウネ	97	5454	6137312	89.6812
5458	大舘	オオダチ	97	5454	6137409	89.6826
5459	鬼木	オニキ	97	5454	6137506	89.684
5460	角張	カクバリ	97	5454	6137603	89.6854
5461	神川	カミカワ	97	5454	6137700	89.6868
5462	唐橋	カラハシ	97	5454	6137797	89.6883
5463	狩俣	カリマタ	97	5454	6137894	89.6897
5464	貴志	キシ	97	5454	6137991	89.6911
5465	隈本	クマモト	97	5454	6138088	89.6925
5466	小金澤	コガネザワ	97	5454	6138185	89.6939
5467	腰塚	コシヅカ	97	5454	6138282	89.6953
5468	小舘	コダテ	97	5454	6138379	89.6968
5469	小袋	コブクロ	97	5454	6138476	89.6982
5470	流石	サスガ	97	5454	6138573	89.6996
5471	近松	チカマツ	97	5454	6138670	89.701
5472	利光	トシミツ	97	5454	6138767	89.7024
5473	戸原	トハラ	97	5454	6138864	89.7038
5474	日塔	ニツトウ	97	5454	6138961	89.7053
5475	羽生田	ハニユウダ	97	5454	6139058	89.7067
5476	原園	ハラゾノ	97	5454	6139155	89.7081
5477	引田	ヒキダ	97	5454	6139252	89.7095
5478	久光	ヒサミツ	97	5454	6139349	89.7109
5479	比田井	ヒダイ	97	5454	6139446	89.7124
5480	桧森	ヒモリ	97	5454	6139543	89.7138
5481	本藤	ホンドウ	97	5454	6139640	89.7152
5482	松前	マツマエ	97	5454	6139737	89.7166
5483	丸谷	マルヤ	97	5454	6139834	89.718
5484	本井	モトイ	97	5454	6139931	89.7194
5485	安	ヤス	97	5454	6140028	89.7209
5486	山倉	ヤマクラ	97	5454	6140125	89.7223
5487	山之口	ヤマノクチ	97	5454	6140222	89.7237
5488	吉尾	ヨシオ	97	5454	6140319	89.7251
5489	井岡	イオカ	96	5489	6140415	89.7265
5490	池水	イケミズ	96	5489	6140511	89.7279
5491	右近	ウコン	96	5489	6140607	89.7293
5492	門口	カドグチ	96	5489	6140703	89.7307
5493	加野	カノ	96	5489	6140799	89.7321
5494	亀沢	カメザワ	96	5489	6140895	89.7335
5495	木佐貫	キサヌキ	96	5489	6140991	89.7349
5496	國吉	クニヨシ	96	5489	6141087	89.7363
5497	小圷	コアクツ	96	5489	6141183	89.7377
5498	幸野	コウノ	96	5489	6141279	89.7391
5499	小木曽	コギソ	96	5489	6141375	89.7405
5500	真保	シンボ	96	5489	6141471	89.7419
5501	千石	センゴク	96	5489	6141567	89.7433
5502	園	ソノ	96	5489	6141663	89.7447
5503	祖父江	ソフエ	96	5489	6141759	89.7462
5504	高波	タカナミ	96	5489	6141855	89.7476
5505	竹渕	タケブチ	96	5489	6141951	89.749
5506	谷平	タニヒラ	96	5489	6142047	89.7504
5507	角守	ツノカミ	96	5489	6142143	89.7518
5508	渡嘉敷	トカシキ	96	5489	6142239	89.7532
5509	冨塚	トミヅカ	96	5489	6142335	89.7546
5510	鳥澤	トリサワ	96	5489	6142431	89.756
5511	中桐	ナカギリ	96	5489	6142527	89.7574
5512	乳井	ニユウイ	96	5489	6142623	89.7588
5513	福	フク	96	5489	6142719	89.7602
5514	堀合	ホリアイ	96	5489	6142815	89.7616
5515	儘田	ママダ	96	5489	6142911	89.763
5516	山鹿	ヤマガ	96	5489	6143007	89.7644
5517	頼	ライ	96	5489	6143103	89.7658
5518	饗場	アイバ	95	5518	6143198	89.7672
5519	明田	アケタ	95	5518	6143293	89.7686
5520	朝見	アサミ	95	5518	6143388	89.77
5521	諫山	イサヤマ	95	5518	6143483	89.7713
5522	磯ケ谷	イソガヤ	95	5518	6143578	89.7727
5523	板橋	イタハシ	95	5518	6143673	89.7741
5524	伊山	イヤマ	95	5518	6143768	89.7755
5525	潮	ウシオ	95	5518	6143863	89.7769
5526	江刺家	エサシカ	95	5518	6143958	89.7783
5527	女屋	オナヤ	95	5518	6144053	89.7797
5528	尾畑	オバタ	95	5518	6144148	89.7811
5529	加田	カダ	95	5518	6144243	89.7824
5530	金平	カネヒラ	95	5518	6144338	89.7838
5531	上	カミ	95	5518	6144433	89.7852
5532	鴨田	カモダ	95	5518	6144528	89.7866
5533	河戸	カワト	95	5518	6144623	89.788
5534	葛原	クズハラ	95	5518	6144718	89.7894
5535	小網	コアミ	95	5518	6144813	89.7908
5536	小町	コマチ	95	5518	6144908	89.7922
5537	塩脇	シオワキ	95	5518	6145003	89.7936
5538	渋木	シブキ	95	5518	6145098	89.7949
5539	白水	シラミズ	95	5518	6145193	89.7963
5540	須合	スゴウ	95	5518	6145288	89.7977
5541	竹石	タケイシ	95	5518	6145383	89.7991
5542	武岡	タケオカ	95	5518	6145478	89.8005
5543	辰己	タツミ	95	5518	6145573	89.8019
5544	田鍋	タナベ	95	5518	6145668	89.8033
5545	辻口	ツジグチ	95	5518	6145763	89.8047
5546	寺師	テラシ	95	5518	6145858	89.806
5547	照山	テルヤマ	95	5518	6145953	89.8074
5548	遠峰	トオミネ	95	5518	6146048	89.8088
5549	鳥養	トリカイ	95	5518	6146143	89.8102
5550	名久井	ナクイ	95	5518	6146238	89.8116
5551	楢崎	ナラサキ	95	5518	6146333	89.813
5552	西ヶ谷	ニシガヤ	95	5518	6146428	89.8144
5553	二之宮	ニノミヤ	95	5518	6146523	89.8158
5554	野平	ノヒラ	95	5518	6146618	89.8172
5555	春口	ハルグチ	95	5518	6146713	89.8185
5556	平	ヒラ	95	5518	6146808	89.8199
5557	藤見	フジミ	95	5518	6146903	89.8213
5558	堀家	ホリケ	95	5518	6146998	89.8227
5559	三壁	ミカベ	95	5518	6147093	89.8241
5560	光井	ミツイ	95	5518	6147188	89.8255
5561	宮垣	ミヤガキ	95	5518	6147283	89.8269
5562	吉木	ヨシキ	95	5518	6147378	89.8283
5563	吉谷	ヨシタニ	95	5518	6147473	89.8296
5564	穴見	アナミ	94	5564	6147567	89.831
5565	稲生	イナオ	94	5564	6147661	89.8324
5566	稲福	イナフク	94	5564	6147755	89.8338
5567	植本	ウエモト	94	5564	6147849	89.8351
5568	大勝	オオカツ	94	5564	6147943	89.8365
5569	上谷	カミヤ	94	5564	6148037	89.8379
5570	川合	カワアイ	94	5564	6148131	89.8393
5571	川地	カワチ	94	5564	6148225	89.8406
5572	清澤	キヨサワ	94	5564	6148319	89.842
5573	窪川	クボカワ	94	5564	6148413	89.8434
5574	倉上	クラカミ	94	5564	6148507	89.8448
5575	栗野	クリノ	94	5564	6148601	89.8461
5576	小田部	コタベ	94	5564	6148695	89.8475
5577	佐貫	サヌキ	94	5564	6148789	89.8489
5578	鎮野	シズノ	94	5564	6148883	89.8503
5579	下岡	シモオカ	94	5564	6148977	89.8516
5580	周藤	シユウトウ	94	5564	6149071	89.853
5581	新間	シンマ	94	5564	6149165	89.8544
5582	菅波	スガナミ	94	5564	6149259	89.8557
5583	五月女	ソウトメ	94	5564	6149353	89.8571
5584	高根沢	タカネザワ	94	5564	6149447	89.8585
5585	■平	タカヒラ	94	5564	6149541	89.8599
5586	田後	タゴ	94	5564	6149635	89.8612
5587	立見	タツミ	94	5564	6149729	89.8626
5588	丹後	タンゴ	94	5564	6149823	89.864
5589	月本	ツキモト	94	5564	6149917	89.8654
5590	常山	ツネヤマ	94	5564	6150011	89.8667
5591	津端	ツバタ	94	5564	6150105	89.8681
5592	徳間	トクマ	94	5564	6150199	89.8695
5593	戸嶋	トジマ	94	5564	6150293	89.8709
5594	新納	ニイロ	94	5564	6150387	89.8722
5595	馬鳥	バトリ	94	5564	6150481	89.8736
5596	東村	ヒガシムラ	94	5564	6150575	89.875
5597	廣部	ヒロベ	94	5564	6150669	89.8763
5598	松隈	マツクマ	94	5564	6150763	89.8777
5599	松土	マツド	94	5564	6150857	89.8791
5600	眞野	マノ	94	5564	6150951	89.8805
5601	三平	ミツヒラ	94	5564	6151045	89.8818
5602	宮之原	ミヤノハラ	94	5564	6151139	89.8832
5603	馬上	モウエ	94	5564	6151233	89.8846
5604	安元	ヤスモト	94	5564	6151327	89.886
5605	與儀	ヨギ	94	5564	6151421	89.8873
5606	竜崎	リユウザキ	94	5564	6151515	89.8887
5607	畦地	アゼチ	93	5607	6151608	89.8901
5608	有薗	アリゾノ	93	5607	6151701	89.8914
5609	岩坂	イワサカ	93	5607	6151794	89.8928
5610	宇梶	ウカジ	93	5607	6151887	89.8941
5611	奥川	オクカワ	93	5607	6151980	89.8955
5612	奥瀬	オクセ	93	5607	6152073	89.8969
5613	奥出	オクデ	93	5607	6152166	89.8982
5614	長利	オサリ	93	5607	6152259	89.8996
5615	尾張	オワリ	93	5607	6152352	89.9009
5616	鹿毛	カゲ	93	5607	6152445	89.9023
5617	風岡	カザオカ	93	5607	6152538	89.9037
5618	亀澤	カメザワ	93	5607	6152631	89.905
5619	苅込	カリコミ	93	5607	6152724	89.9064
5620	河嶋	カワシマ	93	5607	6152817	89.9077
5621	川谷	カワタニ	93	5607	6152910	89.9091
5622	川人	カワヒト	93	5607	6153003	89.9105
5623	川守田	カワモリタ	93	5607	6153096	89.9118
5624	管	カン	93	5607	6153189	89.9132
5625	河野	コオノ	93	5607	6153282	89.9145
5626	古平	コダイラ	93	5607	6153375	89.9159
5627	今田	コンダ	93	5607	6153468	89.9172
5628	斎田	サイタ	93	5607	6153561	89.9186
5629	坂谷	サカタニ	93	5607	6153654	89.92
5630	重	シゲ	93	5607	6153747	89.9213
5631	神藤	ジンドウ	93	5607	6153840	89.9227
5632	杉元	スギモト	93	5607	6153933	89.924
5633	須■	スザキ	93	5607	6154026	89.9254
5634	武島	タケシマ	93	5607	6154119	89.9268
5635	大黒	ダイコク	93	5607	6154212	89.9281
5636	津谷	ツヤ	93	5607	6154305	89.9295
5637	寺脇	テラワキ	93	5607	6154398	89.9308
5638	徳川	トクガワ	93	5607	6154491	89.9322
5639	道家	ドウケ	93	5607	6154584	89.9336
5640	中木	ナカキ	93	5607	6154677	89.9349
5641	仲村渠	ナカンダカリ	93	5607	6154770	89.9363
5642	鍋谷	ナベタニ	93	5607	6154863	89.9376
5643	土師	ハジ	93	5607	6154956	89.939
5644	廣谷	ヒロタニ	93	5607	6155049	89.9404
5645	深水	フカミズ	93	5607	6155142	89.9417
5646	穂谷野	ホヤノ	93	5607	6155235	89.9431
5647	桝井	マスイ	93	5607	6155328	89.9444
5648	松瀬	マツセ	93	5607	6155421	89.9458
5649	皆木	ミナギ	93	5607	6155514	89.9471
5650	目時	メトキ	93	5607	6155607	89.9485
5651	八木沼	ヤギヌマ	93	5607	6155700	89.9499
5652	米元	ヨネモト	93	5607	6155793	89.9512
5653	会津	アイヅ	92	5653	6155885	89.9526
5654	青葉	アオバ	92	5653	6155977	89.9539
5655	秋庭	アキニワ	92	5653	6156069	89.9553
5656	勇	イサミ	92	5653	6156161	89.9566
5657	石津	イシズ	92	5653	6156253	89.9579
5658	石月	イシヅキ	92	5653	6156345	89.9593
5659	大串	オオクシ	92	5653	6156437	89.9606
5660	大手	オオテ	92	5653	6156529	89.962
5661	大間	オオマ	92	5653	6156621	89.9633
5662	大湯	オオユ	92	5653	6156713	89.9647
5663	奥富	オクトミ	92	5653	6156805	89.966
5664	奥間	オクマ	92	5653	6156897	89.9674
5665	金高	カネタカ	92	5653	6156989	89.9687
5666	加村	カムラ	92	5653	6157081	89.97
5667	久能	クノウ	92	5653	6157173	89.9714
5668	上坂	コウサカ	92	5653	6157265	89.9727
5669	斉川	サイカワ	92	5653	6157357	89.9741
5670	重富	シゲトミ	92	5653	6157449	89.9754
5671	下川原	シモカワラ	92	5653	6157541	89.9768
5672	高比良	タカヒラ	92	5653	6157633	89.9781
5673	田熊	タクマ	92	5653	6157725	89.9795
5674	津嶋	ツシマ	92	5653	6157817	89.9808
5675	中小路	ナカコウジ	92	5653	6157909	89.9821
5676	中地	ナカチ	92	5653	6158001	89.9835
5677	永冨	ナガトミ	92	5653	6158093	89.9848
5678	西倉	ニシクラ	92	5653	6158185	89.9862
5679	沼澤	ヌマサワ	92	5653	6158277	89.9875
5680	能戸	ノト	92	5653	6158369	89.9889
5681	濱崎	ハマザキ	92	5653	6158461	89.9902
5682	原田	ハラタ	92	5653	6158553	89.9916
5683	日沼	ヒヌマ	92	5653	6158645	89.9929
5684	真中	マナカ	92	5653	6158737	89.9942
5685	水品	ミズシナ	92	5653	6158829	89.9956
5686	三戸部	ミトベ	92	5653	6158921	89.9969
5687	壬生	ミブ	92	5653	6159013	89.9983
5688	盧	ロ	92	5653	6159105	89.9996
5689	鷲巣	ワシズ	92	5653	6159197	90.001
5690	東谷	アズマヤ	91	5690	6159288	90.0023
5691	荒木田	アラキダ	91	5690	6159379	90.0036
5692	安澤	アンザワ	91	5690	6159470	90.005
5693	飯川	イイカワ	91	5690	6159561	90.0063
5694	磯谷	イソガイ	91	5690	6159652	90.0076
5695	猪原	イノハラ	91	5690	6159743	90.0089
5696	岩屋	イワヤ	91	5690	6159834	90.0103
5697	薄田	ウスダ	91	5690	6159925	90.0116
5698	越前谷	エチゼンヤ	91	5690	6160016	90.0129
5699	大芝	オオシバ	91	5690	6160107	90.0143
5700	大向	オオムカイ	91	5690	6160198	90.0156
5701	大藪	オオヤブ	91	5690	6160289	90.0169
5702	緒形	オガタ	91	5690	6160380	90.0182
5703	皆藤	カイトウ	91	5690	6160471	90.0196
5704	角野	カドノ	91	5690	6160562	90.0209
5705	楠瀬	クスノセ	91	5690	6160653	90.0222
5706	葛生	クズウ	91	5690	6160744	90.0236
5707	小久江	コクエ	91	5690	6160835	90.0249
5708	佐須	サス	91	5690	6160926	90.0262
5709	白銀	シロガネ	91	5690	6161017	90.0276
5710	新戸	シンド	91	5690	6161108	90.0289
5711	駿河	スルガ	91	5690	6161199	90.0302
5712	谷津	タニツ	91	5690	6161290	90.0315
5713	常木	ツネキ	91	5690	6161381	90.0329
5714	津波古	ツハコ	91	5690	6161472	90.0342
5715	常世田	トコヨダ	91	5690	6161563	90.0355
5716	富本	トミモト	91	5690	6161654	90.0369
5717	成尾	ナルオ	91	5690	6161745	90.0382
5718	野坂	ノザカ	91	5690	6161836	90.0395
5719	野下	ノシタ	91	5690	6161927	90.0409
5720	曳地	ヒキチ	91	5690	6162018	90.0422
5721	藤浦	フジウラ	91	5690	6162109	90.0435
5722	本野	モトノ	91	5690	6162200	90.0448
5723	師岡	モロオカ	91	5690	6162291	90.0462
5724	青地	アオチ	90	5724	6162381	90.0475
5725	厚川	アツカワ	90	5724	6162471	90.0488
5726	天本	アマモト	90	5724	6162561	90.0501
5727	飯高	イイタカ	90	5724	6162651	90.0514
5728	石栗	イシグリ	90	5724	6162741	90.0527
5729	猪口	イノクチ	90	5724	6162831	90.0541
5730	梅原	ウメバラ	90	5724	6162921	90.0554
5731	加治木	カジキ	90	5724	6163011	90.0567
5732	勝岡	カツオカ	90	5724	6163101	90.058
5733	金谷	カナタニ	90	5724	6163191	90.0593
5734	金安	カネヤス	90	5724	6163281	90.0606
5735	木浪	キナミ	90	5724	6163371	90.062
5736	桐谷	キリガヤ	90	5724	6163461	90.0633
5737	江	コウ	90	5724	6163551	90.0646
5738	江田	コウダ	90	5724	6163641	90.0659
5739	越地	コシヂ	90	5724	6163731	90.0672
5740	小船	コブネ	90	5724	6163821	90.0685
5741	近田	コンダ	90	5724	6163911	90.0698
5742	寒川	サムカワ	90	5724	6164001	90.0712
5743	篠山	シノヤマ	90	5724	6164091	90.0725
5744	下嶋	シモジマ	90	5724	6164181	90.0738
5745	■	タカ	90	5724	6164271	90.0751
5746	高藤	タカフジ	90	5724	6164361	90.0764
5747	坪倉	ツボクラ	90	5724	6164451	90.0777
5748	出浦	デウラ	90	5724	6164541	90.0791
5749	東田	トウダ	90	5724	6164631	90.0804
5750	遠井	トオイ	90	5724	6164721	90.0817
5751	鳥飼	トリガイ	90	5724	6164811	90.083
5752	西潟	ニシガタ	90	5724	6164901	90.0843
5753	箱守	ハコモリ	90	5724	6164991	90.0856
5754	橋山	ハシヤマ	90	5724	6165081	90.0869
5755	羽野	ハノ	90	5724	6165171	90.0883
5756	原橋	ハラハシ	90	5724	6165261	90.0896
5757	日隈	ヒグマ	90	5724	6165351	90.0909
5758	平坂	ヒラサカ	90	5724	6165441	90.0922
5759	藤坂	フジサカ	90	5724	6165531	90.0935
5760	二俣	フタマタ	90	5724	6165621	90.0948
5761	松並	マツナミ	90	5724	6165711	90.0961
5762	水尾	ミズオ	90	5724	6165801	90.0975
5763	嶺	ミネ	90	5724	6165891	90.0988
5764	谷知	ヤチ	90	5724	6165981	90.1001
5765	■武	ヨシタケ	90	5724	6166071	90.1014
5766	米野	ヨネノ	90	5724	6166161	90.1027
5767	東江	アガリエ	89	5767	6166250	90.104
5768	味岡	アジオカ	89	5767	6166339	90.1053
5769	荒関	アラセキ	89	5767	6166428	90.1066
5770	井谷	イタニ	89	5767	6166517	90.1079
5771	江波	エナミ	89	5767	6166606	90.1092
5772	大阿久	オオアク	89	5767	6166695	90.1105
5773	奥澤	オクザワ	89	5767	6166784	90.1118
5774	小田倉	オダクラ	89	5767	6166873	90.1131
5775	紙透	カミスキ	89	5767	6166962	90.1144
5776	川向	カワムカイ	89	5767	6167051	90.1157
5777	蒲原	カンバラ	89	5767	6167140	90.117
5778	木■	キザキ	89	5767	6167229	90.1183
5779	久島	クシマ	89	5767	6167318	90.1196
5780	神戸	コウベ	89	5767	6167407	90.1209
5781	小笹	コザサ	89	5767	6167496	90.1222
5782	古塩	コシオ	89	5767	6167585	90.1235
5783	古場	コバ	89	5767	6167674	90.1248
5784	郷間	ゴウマ	89	5767	6167763	90.1261
5785	才木	サイキ	89	5767	6167852	90.1274
5786	佐生	サシヨウ	89	5767	6167941	90.1287
5787	實方	サネカタ	89	5767	6168030	90.13
5788	信田	シダ	89	5767	6168119	90.1313
5789	須郷	スゴウ	89	5767	6168208	90.1326
5790	洲崎	スザキ	89	5767	6168297	90.1339
5791	住	スミ	89	5767	6168386	90.1352
5792	蘇	ソ	89	5767	6168475	90.1365
5793	十川	ソガワ	89	5767	6168564	90.1378
5794	竹重	タケシゲ	89	5767	6168653	90.1391
5795	立林	タテバヤシ	89	5767	6168742	90.1404
5796	丹藤	タンドウ	89	5767	6168831	90.1417
5797	丹内	タンナイ	89	5767	6168920	90.143
5798	附田	ツクダ	89	5767	6169009	90.1443
5799	寺崎	テラザキ	89	5767	6169098	90.1456
5800	冨井	トミイ	89	5767	6169187	90.1469
5801	土部	ドベ	89	5767	6169276	90.1482
5802	長畑	ナガハタ	89	5767	6169365	90.1495
5803	奈良輪	ナラワ	89	5767	6169454	90.1508
5804	西里	ニシザト	89	5767	6169543	90.1521
5805	幅	ハバ	89	5767	6169632	90.1534
5806	廣嶋	ヒロシマ	89	5767	6169721	90.1547
5807	広中	ヒロナカ	89	5767	6169810	90.156
5808	広橋	ヒロハシ	89	5767	6169899	90.1573
5809	福冨	フクトミ	89	5767	6169988	90.1586
5810	布田	フダ	89	5767	6170077	90.1599
5811	益山	マスヤマ	89	5767	6170166	90.1612
5812	松中	マツナカ	89	5767	6170255	90.1625
5813	水崎	ミズサキ	89	5767	6170344	90.1638
5814	三代川	ミヨカワ	89	5767	6170433	90.1651
5815	村	ムラ	89	5767	6170522	90.1664
5816	矢木	ヤギ	89	5767	6170611	90.1677
5817	谷田貝	ヤタガイ	89	5767	6170700	90.169
5818	山橋	ヤマハシ	89	5767	6170789	90.1704
5819	山家	ヤマヤ	89	5767	6170878	90.1717
5820	横澤	ヨコサワ	89	5767	6170967	90.173
5821	吉沼	ヨシヌマ	89	5767	6171056	90.1743
5822	■松	ヨシマツ	89	5767	6171145	90.1756
5823	有江	アリエ	88	5823	6171233	90.1768
5824	有岡	アリオカ	88	5823	6171321	90.1781
5825	五十嵐	イカラシ	88	5823	6171409	90.1794
5826	砂金	イサゴ	88	5823	6171497	90.1807
5827	岩男	イワオ	88	5823	6171585	90.182
5828	扇谷	オオギヤ	88	5823	6171673	90.1833
5829	大田原	オオタワラ	88	5823	6171761	90.1846
5830	大藤	オオトウ	88	5823	6171849	90.1858
5831	小柏	オガシワ	88	5823	6171937	90.1871
5832	尾倉	オグラ	88	5823	6172025	90.1884
5833	小畠	オバタ	88	5823	6172113	90.1897
5834	恩蔵	オンゾウ	88	5823	6172201	90.191
5835	菅藤	カントウ	88	5823	6172289	90.1923
5836	逆井	サカサイ	88	5823	6172377	90.1936
5837	■山	サキヤマ	88	5823	6172465	90.1948
5838	神馬	ジンバ	88	5823	6172553	90.1961
5839	関崎	セキザキ	88	5823	6172641	90.1974
5840	曽	ソウ	88	5823	6172729	90.1987
5841	竹浪	タケナミ	88	5823	6172817	90.2
5842	鶴若	ツルワカ	88	5823	6172905	90.2013
5843	天満	テンマ	88	5823	6172993	90.2026
5844	外舘	トダテ	88	5823	6173081	90.2038
5845	鳥塚	トリヅカ	88	5823	6173169	90.2051
5846	中口	ナカグチ	88	5823	6173257	90.2064
5847	仲條	ナカジヨウ	88	5823	6173345	90.2077
5848	長本	ナガモト	88	5823	6173433	90.209
5849	並河	ナミカワ	88	5823	6173521	90.2103
5850	成清	ナリキヨ	88	5823	6173609	90.2116
5851	花島	ハナシマ	88	5823	6173697	90.2128
5852	張替	ハリガエ	88	5823	6173785	90.2141
5853	平吹	ヒラブキ	88	5823	6173873	90.2154
5854	広谷	ヒロタニ	88	5823	6173961	90.2167
5855	戸来	ヘライ	88	5823	6174049	90.218
5856	方	ホウ	88	5823	6174137	90.2193
5857	槙田	マキタ	88	5823	6174225	90.2206
5858	丸林	マルバヤシ	88	5823	6174313	90.2218
5859	三尾	ミオ	88	5823	6174401	90.2231
5860	八柳	ヤツヤナギ	88	5823	6174489	90.2244
5861	横道	ヨコミチ	88	5823	6174577	90.2257
5862	吉冨	ヨシトミ	88	5823	6174665	90.227
5863	渡利	ワタリ	88	5823	6174753	90.2283
5864	青柳	アオヤナギ	87	5864	6174840	90.2295
5865	碓氷	ウスイ	87	5864	6174927	90.2308
5866	宇多	ウダ	87	5864	6175014	90.2321
5867	宇部	ウベ	87	5864	6175101	90.2334
5868	大形	オオガタ	87	5864	6175188	90.2346
5869	大元	オオモト	87	5864	6175275	90.2359
5870	大薮	オオヤブ	87	5864	6175362	90.2372
5871	小嶋	オジマ	87	5864	6175449	90.2384
5872	海瀬	カイセ	87	5864	6175536	90.2397
5873	風巻	カザマキ	87	5864	6175623	90.241
5874	鹿志村	カシムラ	87	5864	6175710	90.2423
5875	勝田	カツダ	87	5864	6175797	90.2435
5876	角屋	カドヤ	87	5864	6175884	90.2448
5877	金津	カナツ	87	5864	6175971	90.2461
5878	金親	カネチカ	87	5864	6176058	90.2473
5879	川津	カワヅ	87	5864	6176145	90.2486
5880	川延	カワノベ	87	5864	6176232	90.2499
5881	清岡	キヨオカ	87	5864	6176319	90.2512
5882	清島	キヨシマ	87	5864	6176406	90.2524
5883	久郷	クゴウ	87	5864	6176493	90.2537
5884	倉部	クラベ	87	5864	6176580	90.255
5885	小坂井	コサカイ	87	5864	6176667	90.2562
5886	小松■	コマツザキ	87	5864	6176754	90.2575
5887	左藤	サトウ	87	5864	6176841	90.2588
5888	三本木	サンボンギ	87	5864	6176928	90.2601
5889	白石	シロイシ	87	5864	6177015	90.2613
5890	関村	セキムラ	87	5864	6177102	90.2626
5891	高岸	タカギシ	87	5864	6177189	90.2639
5892	■畠	タカバタケ	87	5864	6177276	90.2651
5893	田戸	タド	87	5864	6177363	90.2664
5894	徳野	トクノ	87	5864	6177450	90.2677
5895	仲内	ナカウチ	87	5864	6177537	90.269
5896	中久喜	ナカクキ	87	5864	6177624	90.2702
5897	似内	ニタナイ	87	5864	6177711	90.2715
5898	額田	ヌカダ	87	5864	6177798	90.2728
5899	野仲	ノナカ	87	5864	6177885	90.274
5900	白	ハク	87	5864	6177972	90.2753
5901	畑岡	ハタオカ	87	5864	6178059	90.2766
5902	福長	フクナガ	87	5864	6178146	90.2779
5903	振原	フリハラ	87	5864	6178233	90.2791
5904	保延	ホノベ	87	5864	6178320	90.2804
5905	前橋	マエバシ	87	5864	6178407	90.2817
5906	真崎	マザキ	87	5864	6178494	90.2829
5907	益川	マスカワ	87	5864	6178581	90.2842
5908	三廻部	ミクルベ	87	5864	6178668	90.2855
5909	矢尾板	ヤオイタ	87	5864	6178755	90.2868
5910	由比	ユイ	87	5864	6178842	90.288
5911	米内	ヨナイ	87	5864	6178929	90.2893
5912	相浦	アイウラ	86	5912	6179015	90.2906
5913	饗庭	アイバ	86	5912	6179101	90.2918
5914	荒居	アライ	86	5912	6179187	90.2931
5915	伊沢	イサワ	86	5912	6179273	90.2943
5916	泉沢	イズミサワ	86	5912	6179359	90.2956
5917	井深	イブカ	86	5912	6179445	90.2968
5918	上江洲	ウエズ	86	5912	6179531	90.2981
5919	宇藤	ウトウ	86	5912	6179617	90.2993
5920	忍足	オシダリ	86	5912	6179703	90.3006
5921	小保方	オボカタ	86	5912	6179789	90.3019
5922	織笠	オリカサ	86	5912	6179875	90.3031
5923	加賀田	カガタ	86	5912	6179961	90.3044
5924	風戸	カザト	86	5912	6180047	90.3056
5925	兼城	カネシロ	86	5912	6180133	90.3069
5926	栗谷	クリヤ	86	5912	6180219	90.3081
5927	来栖	クルス	86	5912	6180305	90.3094
5928	腰越	コシゴエ	86	5912	6180391	90.3107
5929	越光	コシミツ	86	5912	6180477	90.3119
5930	小嶌	コジマ	86	5912	6180563	90.3132
5931	坂梨	サカナシ	86	5912	6180649	90.3144
5932	佐口	サグチ	86	5912	6180735	90.3157
5933	沢山	サワヤマ	86	5912	6180821	90.3169
5934	島尻	シマジリ	86	5912	6180907	90.3182
5935	清水	シミヅ	86	5912	6180993	90.3195
5936	下城	シモジヨウ	86	5912	6181079	90.3207
5937	下薗	シモゾノ	86	5912	6181165	90.322
5938	霜山	シモヤマ	86	5912	6181251	90.3232
5939	城谷	シロタニ	86	5912	6181337	90.3245
5940	真道	シンドウ	86	5912	6181423	90.3257
5941	関岡	セキオカ	86	5912	6181509	90.327
5942	宋	ソン	86	5912	6181595	90.3283
5943	多々良	タタラ	86	5912	6181681	90.3295
5944	舘林	タテバヤシ	86	5912	6181767	90.3308
5945	塚崎	ツカザキ	86	5912	6181853	90.332
5946	綱嶋	ツナシマ	86	5912	6181939	90.3333
5947	戸羽	トバ	86	5912	6182025	90.3345
5948	中城	ナカジヨウ	86	5912	6182111	90.3358
5949	名雪	ナユキ	86	5912	6182197	90.337
5950	西條	ニシジヨウ	86	5912	6182283	90.3383
5951	糠信	ヌカノブ	86	5912	6182369	90.3396
5952	硲	ハザマ	86	5912	6182455	90.3408
5953	橋	ハシ	86	5912	6182541	90.3421
5954	早船	ハヤフネ	86	5912	6182627	90.3433
5955	久島	ヒサジマ	86	5912	6182713	90.3446
5956	渕	フチ	86	5912	6182799	90.3458
5957	松代	マツシロ	86	5912	6182885	90.3471
5958	松久	マツヒサ	86	5912	6182971	90.3484
5959	間部	マナベ	86	5912	6183057	90.3496
5960	三代	ミシロ	86	5912	6183143	90.3509
5961	水城	ミズキ	86	5912	6183229	90.3521
5962	三藤	ミトウ	86	5912	6183315	90.3534
5963	矢板	ヤイタ	86	5912	6183401	90.3546
5964	■下	ヤギシタ	86	5912	6183487	90.3559
5965	矢原	ヤハラ	86	5912	6183573	90.3572
5966	山沢	ヤマザワ	86	5912	6183659	90.3584
5967	鑓水	ヤリミズ	86	5912	6183745	90.3597
5968	余	ヨ	86	5912	6183831	90.3609
5969	米盛	ヨネモリ	86	5912	6183917	90.3622
5970	阿出川	アデガワ	85	5970	6184002	90.3634
5971	新川	アラカワ	85	5970	6184087	90.3647
5972	板鼻	イタハナ	85	5970	6184172	90.3659
5973	井ノ口	イノグチ	85	5970	6184257	90.3672
5974	猪爪	イノツメ	85	5970	6184342	90.3684
5975	小笠	オガサ	85	5970	6184427	90.3696
5976	桶谷	オケタニ	85	5970	6184512	90.3709
5977	乙川	オトガワ	85	5970	6184597	90.3721
5978	金巻	カネマキ	85	5970	6184682	90.3734
5979	上坂	カミサカ	85	5970	6184767	90.3746
5980	川邉	カワベ	85	5970	6184852	90.3758
5981	北谷	キタタニ	85	5970	6184937	90.3771
5982	串間	クシマ	85	5970	6185022	90.3783
5983	桑子	クワコ	85	5970	6185107	90.3796
5984	小鹿	コシカ	85	5970	6185192	90.3808
5985	児嶋	コジマ	85	5970	6185277	90.3821
5986	小永井	コナガイ	85	5970	6185362	90.3833
5987	郷田	ゴウダ	85	5970	6185447	90.3845
5988	郷野	ゴウノ	85	5970	6185532	90.3858
5989	塩谷	シオノヤ	85	5970	6185617	90.387
5990	塩屋	シオヤ	85	5970	6185702	90.3883
5991	七田	シチダ	85	5970	6185787	90.3895
5992	志茂	シモ	85	5970	6185872	90.3908
5993	白水	シロウズ	85	5970	6185957	90.392
5994	■根	タカネ	85	5970	6186042	90.3932
5995	高見澤	タカミザワ	85	5970	6186127	90.3945
5996	田■	タザキ	85	5970	6186212	90.3957
5997	鶴田	ツルダ	85	5970	6186297	90.397
5998	■永	トクナガ	85	5970	6186382	90.3982
5999	飛沢	トビサワ	85	5970	6186467	90.3994
6000	豊口	トヨグチ	85	5970	6186552	90.4007
6001	内木	ナイキ	85	5970	6186637	90.4019
6002	中須	ナカス	85	5970	6186722	90.4032
6003	中鉢	ナカバチ	85	5970	6186807	90.4044
6004	成島	ナリシマ	85	5970	6186892	90.4057
6005	新里	ニイザト	85	5970	6186977	90.4069
6006	西林	ニシバヤシ	85	5970	6187062	90.4081
6007	根立	ネダチ	85	5970	6187147	90.4094
6008	野畑	ノバタ	85	5970	6187232	90.4106
6009	橋井	ハシイ	85	5970	6187317	90.4119
6010	原崎	ハラサキ	85	5970	6187402	90.4131
6011	治田	ハルタ	85	5970	6187487	90.4143
6012	平出	ヒラデ	85	5970	6187572	90.4156
6013	柾木	マサキ	85	5970	6187657	90.4168
6014	道川	ミチカワ	85	5970	6187742	90.4181
6015	村永	ムラナガ	85	5970	6187827	90.4193
6016	樅山	モミヤマ	85	5970	6187912	90.4206
6017	八角	ヤスミ	85	5970	6187997	90.4218
6018	山県	ヤマガタ	85	5970	6188082	90.423
6019	湯上	ユガミ	85	5970	6188167	90.4243
6020	四本	ヨツモト	85	5970	6188252	90.4255
6021	飯盛	イイモリ	84	6021	6188336	90.4268
6022	石浜	イシハマ	84	6021	6188420	90.428
6023	一場	イチバ	84	6021	6188504	90.4292
6024	稲	イナ	84	6021	6188588	90.4304
6025	井下	イノシタ	84	6021	6188672	90.4317
6026	尹	イン	84	6021	6188756	90.4329
6027	上床	ウワトコ	84	6021	6188840	90.4341
6028	鬼丸	オニマル	84	6021	6188924	90.4353
6029	織原	オリハラ	84	6021	6189008	90.4366
6030	海東	カイトウ	84	6021	6189092	90.4378
6031	加賀山	カガヤマ	84	6021	6189176	90.439
6032	垣本	カキモト	84	6021	6189260	90.4403
6033	蒲池	カマチ	84	6021	6189344	90.4415
6034	萱森	カヤモリ	84	6021	6189428	90.4427
6035	神澤	カンザワ	84	6021	6189512	90.4439
6036	北谷	キタヤ	84	6021	6189596	90.4452
6037	桐沢	キリサワ	84	6021	6189680	90.4464
6038	黒山	クロヤマ	84	6021	6189764	90.4476
6039	小内	コウチ	84	6021	6189848	90.4488
6040	五味渕	ゴミブチ	84	6021	6189932	90.4501
6041	塩塚	シオヅカ	84	6021	6190016	90.4513
6042	鹿内	シカウチ	84	6021	6190100	90.4525
6043	重盛	シゲモリ	84	6021	6190184	90.4538
6044	白瀬	シラセ	84	6021	6190268	90.455
6045	白土	シラツチ	84	6021	6190352	90.4562
6046	城本	シロモト	84	6021	6190436	90.4574
6047	末■	スエヨシ	84	6021	6190520	90.4587
6048	杉渕	スギブチ	84	6021	6190604	90.4599
6049	関森	セキモリ	84	6021	6190688	90.4611
6050	十亀	ソガメ	84	6021	6190772	90.4624
6051	蘇武	ソブ	84	6021	6190856	90.4636
6052	棚瀬	タナセ	84	6021	6190940	90.4648
6053	沈	チン	84	6021	6191024	90.466
6054	坪山	ツボヤマ	84	6021	6191108	90.4673
6055	唐	トウ	84	6021	6191192	90.4685
6056	富塚	トミツカ	84	6021	6191276	90.4697
6057	友寄	トモヨセ	84	6021	6191360	90.4709
6058	中釜	ナカガマ	84	6021	6191444	90.4722
6059	根村	ネムラ	84	6021	6191528	90.4734
6060	濱銀	ハマギン	84	6021	6191612	90.4746
6061	濱村	ハマムラ	84	6021	6191696	90.4759
6062	深田	フカタ	84	6021	6191780	90.4771
6063	福浦	フクウラ	84	6021	6191864	90.4783
6064	福丸	フクマル	84	6021	6191948	90.4795
6065	船岡	フナオカ	84	6021	6192032	90.4808
6066	本沢	ホンザワ	84	6021	6192116	90.482
6067	松成	マツナリ	84	6021	6192200	90.4832
6068	溝川	ミゾカワ	84	6021	6192284	90.4844
6069	盛山	モリヤマ	84	6021	6192368	90.4857
6070	山端	ヤマハタ	84	6021	6192452	90.4869
6071	四方	ヨモ	84	6021	6192536	90.4881
6072	穴水	アナミズ	83	6072	6192619	90.4893
6073	浦上	ウラガミ	83	6072	6192702	90.4906
6074	岡原	オカハラ	83	6072	6192785	90.4918
6075	小野山	オノヤマ	83	6072	6192868	90.493
6076	加々見	カガミ	83	6072	6192951	90.4942
6077	金刺	カナザシ	83	6072	6193034	90.4954
6078	蒲田	カマタ	83	6072	6193117	90.4966
6079	川内	カワチ	83	6072	6193200	90.4978
6080	川見	カワミ	83	6072	6193283	90.499
6081	清永	キヨナガ	83	6072	6193366	90.5003
6082	空閑	クガ	83	6072	6193449	90.5015
6083	国武	クニタケ	83	6072	6193532	90.5027
6084	國本	クニモト	83	6072	6193615	90.5039
6085	熊川	クマガワ	83	6072	6193698	90.5051
6086	倉野	クラノ	83	6072	6193781	90.5063
6087	慶野	ケイノ	83	6072	6193864	90.5075
6088	小金丸	コガネマル	83	6072	6193947	90.5087
6089	五ノ井	ゴノイ	83	6072	6194030	90.51
6090	最首	サイシユ	83	6072	6194113	90.5112
6091	阪間	サカマ	83	6072	6194196	90.5124
6092	笹子	ササコ	83	6072	6194279	90.5136
6093	島谷	シマヤ	83	6072	6194362	90.5148
6094	庄山	シヨウヤマ	83	6072	6194445	90.516
6095	水津	スイヅ	83	6072	6194528	90.5172
6096	須磨	スマ	83	6072	6194611	90.5184
6097	副田	ソエダ	83	6072	6194694	90.5197
6098	滝下	タキシタ	83	6072	6194777	90.5209
6099	田城	タシロ	83	6072	6194860	90.5221
6100	但木	タダキ	83	6072	6194943	90.5233
6101	月野	ツキノ	83	6072	6195026	90.5245
6102	勅使川原	テシガワラ	83	6072	6195109	90.5257
6103	名児耶	ナゴヤ	83	6072	6195192	90.5269
6104	西片	ニシカタ	83	6072	6195275	90.5282
6105	西■	ニシザキ	83	6072	6195358	90.5294
6106	浜元	ハマモト	83	6072	6195441	90.5306
6107	舟久保	フナクボ	83	6072	6195524	90.5318
6108	細谷	ホソタニ	83	6072	6195607	90.533
6109	見崎	ミサキ	83	6072	6195690	90.5342
6110	南田	ミナミダ	83	6072	6195773	90.5354
6111	村形	ムラカタ	83	6072	6195856	90.5366
6112	村下	ムラシタ	83	6072	6195939	90.5379
6113	■沼	ヤギヌマ	83	6072	6196022	90.5391
6114	簗田	ヤナダ	83	6072	6196105	90.5403
6115	谷野	ヤノ	83	6072	6196188	90.5415
6116	朝妻	アサヅマ	82	6116	6196270	90.5427
6117	池森	イケモリ	82	6116	6196352	90.5439
6118	井尻	イジリ	82	6116	6196434	90.5451
6119	磯上	イソガミ	82	6116	6196516	90.5463
6120	井ノ上	イノウエ	82	6116	6196598	90.5475
6121	猪口	イノグチ	82	6116	6196680	90.5487
6122	伊村	イムラ	82	6116	6196762	90.5499
6123	上里	ウエサト	82	6116	6196844	90.5511
6124	逢坂	オオサカ	82	6116	6196926	90.5523
6125	奥平	オクヒラ	82	6116	6197008	90.5535
6126	押木	オシキ	82	6116	6197090	90.5547
6127	小花	オバナ	82	6116	6197172	90.5559
6128	兼本	カネモト	82	6116	6197254	90.5571
6129	樺澤	カバサワ	82	6116	6197336	90.5583
6130	紙屋	カミヤ	82	6116	6197418	90.5595
6131	亀田	カメタ	82	6116	6197500	90.5607
6132	河越	カワゴエ	82	6116	6197582	90.5619
6133	木皿	キサラ	82	6116	6197664	90.5631
6134	楠美	クスミ	82	6116	6197746	90.5643
6135	倉	クラ	82	6116	6197828	90.5655
6136	栗原	クリバラ	82	6116	6197910	90.5667
6137	小越	コゴシ	82	6116	6197992	90.5679
6138	小澤	コザワ	82	6116	6198074	90.5691
6139	小和田	コワダ	82	6116	6198156	90.5702
6140	貞方	サダカタ	82	6116	6198238	90.5714
6141	澤地	サワジ	82	6116	6198320	90.5726
6142	滋野	シゲノ	82	6116	6198402	90.5738
6143	鎮目	シズメ	82	6116	6198484	90.575
6144	下舘	シモダテ	82	6116	6198566	90.5762
6145	下津	シモツ	82	6116	6198648	90.5774
6146	栖原	スハラ	82	6116	6198730	90.5786
6147	滝山	タキヤマ	82	6116	6198812	90.5798
6148	田平	タビラ	82	6116	6198894	90.581
6149	都留	ツル	82	6116	6198976	90.5822
6150	寺谷	テラタニ	82	6116	6199058	90.5834
6151	藤内	トウナイ	82	6116	6199140	90.5846
6152	飛川	トビカワ	82	6116	6199222	90.5858
6153	中下	ナカシタ	82	6116	6199304	90.587
6154	野武	ノタケ	82	6116	6199386	90.5882
6155	備前	ビゼン	82	6116	6199468	90.5894
6156	吹野	フキノ	82	6116	6199550	90.5906
6157	俣野	マタノ	82	6116	6199632	90.5918
6158	丸屋	マルヤ	82	6116	6199714	90.593
6159	皆木	ミナキ	82	6116	6199796	90.5942
6160	安居	ヤスイ	82	6116	6199878	90.5954
6161	四家	ヨツヤ	82	6116	6199960	90.5966
6162	秋■	アキヨシ	81	6162	6200041	90.5978
6163	飯浜	イイハマ	81	6162	6200122	90.599
6164	伊熊	イクマ	81	6162	6200203	90.6002
6165	石	イシ	81	6162	6200284	90.6013
6166	石間	イシマ	81	6162	6200365	90.6025
6167	一丸	イチマル	81	6162	6200446	90.6037
6168	上谷	ウエタニ	81	6162	6200527	90.6049
6169	海上	ウナガミ	81	6162	6200608	90.6061
6170	大和久	オオワク	81	6162	6200689	90.6073
6171	岡松	オカマツ	81	6162	6200770	90.6084
6172	乙黒	オトグロ	81	6162	6200851	90.6096
6173	門野	カドノ	81	6162	6200932	90.6108
6174	川嵜	カワサキ	81	6162	6201013	90.612
6175	神作	カンサク	81	6162	6201094	90.6132
6176	喜多川	キタガワ	81	6162	6201175	90.6144
6177	轡田	クツワダ	81	6162	6201256	90.6155
6178	国弘	クニヒロ	81	6162	6201337	90.6167
6179	倉品	クラシナ	81	6162	6201418	90.6179
6180	倉富	クラトミ	81	6162	6201499	90.6191
6181	呉地	クレチ	81	6162	6201580	90.6203
6182	今藤	コンドウ	81	6162	6201661	90.6215
6183	坂尻	サカジリ	81	6162	6201742	90.6226
6184	佐久本	サクモト	81	6162	6201823	90.6238
6185	酒向	サコウ	81	6162	6201904	90.625
6186	里山	サトヤマ	81	6162	6201985	90.6262
6187	市東	シトウ	81	6162	6202066	90.6274
6188	下条	シモジヨウ	81	6162	6202147	90.6286
6189	神保	ジンボウ	81	6162	6202228	90.6298
6190	千々岩	チヂイワ	81	6162	6202309	90.6309
6191	圓谷	ツブラヤ	81	6162	6202390	90.6321
6192	東宮	トウミヤ	81	6162	6202471	90.6333
6193	永安	ナガヤス	81	6162	6202552	90.6345
6194	名村	ナムラ	81	6162	6202633	90.6357
6195	羽原	ハバラ	81	6162	6202714	90.6369
6196	番匠	バンシヨウ	81	6162	6202795	90.638
6197	飛弾	ヒダ	81	6162	6202876	90.6392
6198	弘瀬	ヒロセ	81	6162	6202957	90.6404
6199	舟越	フナコシ	81	6162	6203038	90.6416
6200	北条	ホウジヨウ	81	6162	6203119	90.6428
6201	水石	ミズイシ	81	6162	6203200	90.644
6202	箕田	ミノダ	81	6162	6203281	90.6451
6203	森崎	モリザキ	81	6162	6203362	90.6463
6204	弥永	ヤナガ	81	6162	6203443	90.6475
6205	薮下	ヤブシタ	81	6162	6203524	90.6487
6206	山影	ヤマカゲ	81	6162	6203605	90.6499
6207	山仲	ヤマナカ	81	6162	6203686	90.6511
6208	世安	ヨヤス	81	6162	6203767	90.6522
6209	淺野	アサノ	80	6209	6203847	90.6534
6210	天羽	アモウ	80	6209	6203927	90.6546
6211	荒金	アラカネ	80	6209	6204007	90.6557
6212	有原	アリハラ	80	6209	6204087	90.6569
6213	飯干	イイボシ	80	6209	6204167	90.6581
6214	井垣	イガキ	80	6209	6204247	90.6593
6215	猪子	イノコ	80	6209	6204327	90.6604
6216	上薗	ウエゾノ	80	6209	6204407	90.6616
6217	枝川	エダガワ	80	6209	6204487	90.6628
6218	王子	オウジ	80	6209	6204567	90.6639
6219	翁	オキナ	80	6209	6204647	90.6651
6220	小田切	オタギリ	80	6209	6204727	90.6663
6221	尾■	オダカ	80	6209	6204807	90.6674
6222	勝倉	カツクラ	80	6209	6204887	90.6686
6223	金尾	カナオ	80	6209	6204967	90.6698
6224	上西	カミニシ	80	6209	6205047	90.6709
6225	唐牛	カロウジ	80	6209	6205127	90.6721
6226	川角	カワスミ	80	6209	6205207	90.6733
6227	木場	キバ	80	6209	6205287	90.6745
6228	栗岡	クリオカ	80	6209	6205367	90.6756
6229	狐塚	コヅカ	80	6209	6205447	90.6768
6230	小橋川	コバシガワ	80	6209	6205527	90.678
6231	作田	サクダ	80	6209	6205607	90.6791
6232	島崎	シマサキ	80	6209	6205687	90.6803
6233	下	シモ	80	6209	6205767	90.6815
6234	下枝	シモエダ	80	6209	6205847	90.6826
6235	末	スエ	80	6209	6205927	90.6838
6236	千代	チヨ	80	6209	6206007	90.685
6237	出島	デジマ	80	6209	6206087	90.6861
6238	東谷	トウヤ	80	6209	6206167	90.6873
6239	戸島	トジマ	80	6209	6206247	90.6885
6240	永木	ナガキ	80	6209	6206327	90.6896
6241	永里	ナガサト	80	6209	6206407	90.6908
6242	法月	ノリヅキ	80	6209	6206487	90.692
6243	濱川	ハマカワ	80	6209	6206567	90.6932
6244	深浦	フカウラ	80	6209	6206647	90.6943
6245	福泉	フクイズミ	80	6209	6206727	90.6955
6246	藤縄	フジナワ	80	6209	6206807	90.6967
6247	細越	ホソゴエ	80	6209	6206887	90.6978
6248	明神	ミヨウジン	80	6209	6206967	90.699
6249	山澤	ヤマザワ	80	6209	6207047	90.7002
6250	脇屋	ワキヤ	80	6209	6207127	90.7013
6251	割田	ワリタ	80	6209	6207207	90.7025
6252	綾	アヤ	79	6252	6207286	90.7037
6253	伊倉	イグラ	79	6252	6207365	90.7048
6254	池ヶ谷	イケガヤ	79	6252	6207444	90.706
6255	石浦	イシウラ	79	6252	6207523	90.7071
6256	一瀬	イチセ	79	6252	6207602	90.7083
6257	稲子	イナゴ	79	6252	6207681	90.7094
6258	今津	イマズ	79	6252	6207760	90.7106
6259	岩舘	イワダテ	79	6252	6207839	90.7117
6260	江嶋	エジマ	79	6252	6207918	90.7129
6261	大溝	オオミゾ	79	6252	6207997	90.7141
6262	忍足	オシタリ	79	6252	6208076	90.7152
6263	折笠	オリガサ	79	6252	6208155	90.7164
6264	栫	カコイ	79	6252	6208234	90.7175
6265	鹿沼	カヌマ	79	6252	6208313	90.7187
6266	河津	カワズ	79	6252	6208392	90.7198
6267	冠	カンムリ	79	6252	6208471	90.721
6268	木暮	キグレ	79	6252	6208550	90.7221
6269	北垣	キタガキ	79	6252	6208629	90.7233
6270	北河	キタガワ	79	6252	6208708	90.7244
6271	橘高	キツタカ	79	6252	6208787	90.7256
6272	久木野	クキノ	79	6252	6208866	90.7267
6273	桑田	クワダ	79	6252	6208945	90.7279
6274	源田	ゲンダ	79	6252	6209024	90.7291
6275	駒木根	コマキネ	79	6252	6209103	90.7302
6276	笹目	ササメ	79	6252	6209182	90.7314
6277	塩津	シオツ	79	6252	6209261	90.7325
6278	澁澤	シブサワ	79	6252	6209340	90.7337
6279	宿谷	シユクヤ	79	6252	6209419	90.7348
6280	清藤	セイドウ	79	6252	6209498	90.736
6281	関井	セキイ	79	6252	6209577	90.7371
6282	高浦	タカウラ	79	6252	6209656	90.7383
6283	■月	タカツキ	79	6252	6209735	90.7394
6284	田熊	タグマ	79	6252	6209814	90.7406
6285	竹市	タケイチ	79	6252	6209893	90.7418
6286	竹縄	タケナワ	79	6252	6209972	90.7429
6287	千々和	チヂワ	79	6252	6210051	90.7441
6288	蔦	ツタ	79	6252	6210130	90.7452
6289	恒吉	ツネヨシ	79	6252	6210209	90.7464
6290	津守	ツモリ	79	6252	6210288	90.7475
6291	豊山	トヨヤマ	79	6252	6210367	90.7487
6292	土手	ドテ	79	6252	6210446	90.7498
6293	中峰	ナカミネ	79	6252	6210525	90.751
6294	名波	ナナミ	79	6252	6210604	90.7521
6295	西館	ニシダテ	79	6252	6210683	90.7533
6296	能瀬	ノセ	79	6252	6210762	90.7545
6297	蜂屋	ハチヤ	79	6252	6210841	90.7556
6298	濱岡	ハマオカ	79	6252	6210920	90.7568
6299	林原	ハヤシバラ	79	6252	6210999	90.7579
6300	廣中	ヒロナカ	79	6252	6211078	90.7591
6301	冨士	フジ	79	6252	6211157	90.7602
6302	星原	ホシハラ	79	6252	6211236	90.7614
6303	前田	マエタ	79	6252	6211315	90.7625
6304	元村	モトムラ	79	6252	6211394	90.7637
6305	森尻	モリジリ	79	6252	6211473	90.7648
6306	谷内	ヤチ	79	6252	6211552	90.766
6307	八橋	ヤツハシ	79	6252	6211631	90.7672
6308	柳橋	ヤナギハシ	79	6252	6211710	90.7683
6309	山代	ヤマシロ	79	6252	6211789	90.7695
6310	山地	ヤマヂ	79	6252	6211868	90.7706
6311	米木	ヨネキ	79	6252	6211947	90.7718
6312	芦刈	アシカリ	78	6312	6212025	90.7729
6313	嵐田	アラシダ	78	6312	6212103	90.774
6314	荒武	アラタケ	78	6312	6212181	90.7752
6315	有竹	アリタケ	78	6312	6212259	90.7763
6316	安間	アンマ	78	6312	6212337	90.7775
6317	井ノ口	イノクチ	78	6312	6212415	90.7786
6318	今江	イマエ	78	6312	6212493	90.7797
6319	岡宮	オカミヤ	78	6312	6212571	90.7809
6320	乙川	オトカワ	78	6312	6212649	90.782
6321	柿元	カキモト	78	6312	6212727	90.7832
6322	鍵谷	カギヤ	78	6312	6212805	90.7843
6323	角	カク	78	6312	6212883	90.7854
6324	門屋	カドヤ	78	6312	6212961	90.7866
6325	川井田	カワイダ	78	6312	6213039	90.7877
6326	河原田	カワラダ	78	6312	6213117	90.7889
6327	宜保	ギボ	78	6312	6213195	90.79
6328	神津	コウズ	78	6312	6213273	90.7911
6329	桑折	コオリ	78	6312	6213351	90.7923
6330	佐渡山	サドヤマ	78	6312	6213429	90.7934
6331	澤内	サワウチ	78	6312	6213507	90.7946
6332	生野	シヨウノ	78	6312	6213585	90.7957
6333	秦	シン	78	6312	6213663	90.7968
6334	杉島	スギシマ	78	6312	6213741	90.798
6335	薗	ソノ	78	6312	6213819	90.7991
6336	竹	タケ	78	6312	6213897	90.8003
6337	竹上	タケガミ	78	6312	6213975	90.8014
6338	谷水	タニミズ	78	6312	6214053	90.8025
6339	辻内	ツジウチ	78	6312	6214131	90.8037
6340	苗村	ナエムラ	78	6312	6214209	90.8048
6341	仲程	ナカホド	78	6312	6214287	90.806
6342	中和	ナカワ	78	6312	6214365	90.8071
6343	永作	ナガサク	78	6312	6214443	90.8082
6344	永留	ナガトメ	78	6312	6214521	90.8094
6345	西室	ニシムロ	78	6312	6214599	90.8105
6346	西依	ニシヨリ	78	6312	6214677	90.8117
6347	野水	ノミズ	78	6312	6214755	90.8128
6348	箱石	ハコイシ	78	6312	6214833	90.8139
6349	濱■	ハマサキ	78	6312	6214911	90.8151
6350	浜地	ハマチ	78	6312	6214989	90.8162
6351	濱名	ハマナ	78	6312	6215067	90.8174
6352	林部	ハヤシベ	78	6312	6215145	90.8185
6353	紅谷	ベニヤ	78	6312	6215223	90.8196
6354	星子	ホシコ	78	6312	6215301	90.8208
6355	松塚	マツヅカ	78	6312	6215379	90.8219
6356	三池	ミイケ	78	6312	6215457	90.8231
6357	満尾	ミツオ	78	6312	6215535	90.8242
6358	元島	モトジマ	78	6312	6215613	90.8253
6359	保井	ヤスイ	78	6312	6215691	90.8265
6360	保川	ヤスカワ	78	6312	6215769	90.8276
6361	山腰	ヤマコシ	78	6312	6215847	90.8288
6362	横原	ヨコハラ	78	6312	6215925	90.8299
6363	横村	ヨコムラ	78	6312	6216003	90.831
6364	若佐	ワカサ	78	6312	6216081	90.8322
6365	鷲野	ワシノ	78	6312	6216159	90.8333
6366	芦名	アシナ	77	6366	6216236	90.8344
6367	天津	アマツ	77	6366	6216313	90.8356
6368	岩撫	イワナデ	77	6366	6216390	90.8367
6369	上垣	ウエガキ	77	6366	6216467	90.8378
6370	薄木	ウスキ	77	6366	6216544	90.8389
6371	江野	エノ	77	6366	6216621	90.8401
6372	大河原	オオガワラ	77	6366	6216698	90.8412
6373	大喜多	オオキタ	77	6366	6216775	90.8423
6374	大吉	オオヨシ	77	6366	6216852	90.8434
6375	奥崎	オクザキ	77	6366	6216929	90.8446
6376	奥森	オクモリ	77	6366	6217006	90.8457
6377	折茂	オリモ	77	6366	6217083	90.8468
6378	梶間	カジマ	77	6366	6217160	90.8479
6379	堅田	カタダ	77	6366	6217237	90.8491
6380	唐津	カラツ	77	6366	6217314	90.8502
6381	桐野	キリノ	77	6366	6217391	90.8513
6382	國島	クニシマ	77	6366	6217468	90.8524
6383	熊谷	クマガエ	77	6366	6217545	90.8536
6384	具志	グシ	77	6366	6217622	90.8547
6385	小薬	コグスリ	77	6366	6217699	90.8558
6386	越田	コシタ	77	6366	6217776	90.8569
6387	紺谷	コンタニ	77	6366	6217853	90.8581
6388	五味川	ゴミカワ	77	6366	6217930	90.8592
6389	崎野	サキノ	77	6366	6218007	90.8603
6390	佐々野	ササノ	77	6366	6218084	90.8614
6391	塩■	シオザキ	77	6366	6218161	90.8626
6392	白旗	シラハタ	77	6366	6218238	90.8637
6393	荘	ソウ	77	6366	6218315	90.8648
6394	外間	ソトマ	77	6366	6218392	90.8659
6395	祖父江	ソブエ	77	6366	6218469	90.8671
6396	■野	タツノ	77	6366	6218546	90.8682
6397	譚	タン	77	6366	6218623	90.8693
6398	中筋	ナカスジ	77	6366	6218700	90.8704
6399	名倉	ナクラ	77	6366	6218777	90.8716
6400	仁平	ニダイラ	77	6366	6218854	90.8727
6401	■口	ハマグチ	77	6366	6218931	90.8738
6402	春原	ハルハラ	77	6366	6219008	90.8749
6403	坂野	バンノ	77	6366	6219085	90.8761
6404	古越	フルコシ	77	6366	6219162	90.8772
6405	誉田	ホンダ	77	6366	6219239	90.8783
6406	巻口	マキグチ	77	6366	6219316	90.8794
6407	松重	マツシゲ	77	6366	6219393	90.8806
6408	溝辺	ミゾベ	77	6366	6219470	90.8817
6409	道山	ミチヤマ	77	6366	6219547	90.8828
6410	蓑宮	ミノミヤ	77	6366	6219624	90.8839
6411	牟田口	ムタグチ	77	6366	6219701	90.8851
6412	森藤	モリフジ	77	6366	6219778	90.8862
6413	門奈	モンナ	77	6366	6219855	90.8873
6414	山原	ヤマハラ	77	6366	6219932	90.8885
6415	阿井	アイ	76	6415	6220008	90.8896
6416	相葉	アイバ	76	6415	6220084	90.8907
6417	赤石沢	アカイシザワ	76	6415	6220160	90.8918
6418	浅木	アサキ	76	6415	6220236	90.8929
6419	新江	アラエ	76	6415	6220312	90.894
6420	阿波	アワ	76	6415	6220388	90.8951
6421	阿武	アンノ	76	6415	6220464	90.8962
6422	伊草	イグサ	76	6415	6220540	90.8973
6423	泉谷	イズミタニ	76	6415	6220616	90.8984
6424	井関	イゼキ	76	6415	6220692	90.8996
6425	稲澤	イナザワ	76	6415	6220768	90.9007
6426	岩浪	イワナミ	76	6415	6220844	90.9018
6427	江草	エグサ	76	6415	6220920	90.9029
6428	岡谷	オカヤ	76	6415	6220996	90.904
6429	沖崎	オキザキ	76	6415	6221072	90.9051
6430	小野塚	オノズカ	76	6415	6221148	90.9062
6431	親松	オヤマツ	76	6415	6221224	90.9073
6432	会田	カイダ	76	6415	6221300	90.9084
6433	片木	カタギ	76	6415	6221376	90.9096
6434	神谷	カミタニ	76	6415	6221452	90.9107
6435	河手	カワテ	76	6415	6221528	90.9118
6436	川和	カワワ	76	6415	6221604	90.9129
6437	木沢	キザワ	76	6415	6221680	90.914
6438	北里	キタザト	76	6415	6221756	90.9151
6439	邱	キユウ	76	6415	6221832	90.9162
6440	草島	クサジマ	76	6415	6221908	90.9173
6441	日馬	クサマ	76	6415	6221984	90.9184
6442	國松	クニマツ	76	6415	6222060	90.9195
6443	窪寺	クボデラ	76	6415	6222136	90.9207
6444	鴻野	コウノ	76	6415	6222212	90.9218
6445	古島	コジマ	76	6415	6222288	90.9229
6446	小番	コツガイ	76	6415	6222364	90.924
6447	相模	サガミ	76	6415	6222440	90.9251
6448	信田	シノダ	76	6415	6222516	90.9262
6449	芝口	シバグチ	76	6415	6222592	90.9273
6450	鋤柄	スキガラ	76	6415	6222668	90.9284
6451	瀬上	セガミ	76	6415	6222744	90.9295
6452	■取	タカトリ	76	6415	6222820	90.9307
6453	高畠	タカハタ	76	6415	6222896	90.9318
6454	瀧沢	タキザワ	76	6415	6222972	90.9329
6455	工	タクミ	76	6415	6223048	90.934
6456	武士	タケシ	76	6415	6223124	90.9351
6457	立岩	タテイワ	76	6415	6223200	90.9362
6458	田林	タバヤシ	76	6415	6223276	90.9373
6459	田向	タムカイ	76	6415	6223352	90.9384
6460	俵山	タワラヤマ	76	6415	6223428	90.9395
6461	大東	ダイトウ	76	6415	6223504	90.9406
6462	千明	チアキ	76	6415	6223580	90.9418
6463	千種	チグサ	76	6415	6223656	90.9429
6464	鶴谷	ツルタニ	76	6415	6223732	90.944
6465	戸枝	トエダ	76	6415	6223808	90.9451
6466	中前	ナカマエ	76	6415	6223884	90.9462
6467	長川	ナガカワ	76	6415	6223960	90.9473
6468	根木	ネギ	76	6415	6224036	90.9484
6469	能美	ノウミ	76	6415	6224112	90.9495
6470	登	ノボリ	76	6415	6224188	90.9506
6471	榛沢	ハンザワ	76	6415	6224264	90.9518
6472	東谷	ヒガシタニ	76	6415	6224340	90.9529
6473	久岡	ヒサオカ	76	6415	6224416	90.954
6474	福家	フケ	76	6415	6224492	90.9551
6475	藤津	フジツ	76	6415	6224568	90.9562
6476	星■	ホシザキ	76	6415	6224644	90.9573
6477	前多	マエダ	76	6415	6224720	90.9584
6478	幕内	マクウチ	76	6415	6224796	90.9595
6479	松竹	マツタケ	76	6415	6224872	90.9606
6480	松浪	マツナミ	76	6415	6224948	90.9617
6481	三本	ミモト	76	6415	6225024	90.9629
6482	宗方	ムネカタ	76	6415	6225100	90.964
6483	矢地	ヤチ	76	6415	6225176	90.9651
6484	米永	ヨネナガ	76	6415	6225252	90.9662
6485	呂	ロ	76	6415	6225328	90.9673
6486	相坂	アイサカ	75	6486	6225403	90.9684
6487	赤野	アカノ	75	6486	6225478	90.9695
6488	上石	アゲイシ	75	6486	6225553	90.9706
6489	新崎	アラサキ	75	6486	6225628	90.9717
6490	荒島	アラシマ	75	6486	6225703	90.9728
6491	荒野	アラノ	75	6486	6225778	90.9739
6492	安齊	アンザイ	75	6486	6225853	90.975
6493	飯窪	イイクボ	75	6486	6225928	90.9761
6494	池下	イケシタ	75	6486	6226003	90.9772
6495	池之上	イケノウエ	75	6486	6226078	90.9783
6496	井島	イシマ	75	6486	6226153	90.9794
6497	磯本	イソモト	75	6486	6226228	90.9805
6498	井手口	イデグチ	75	6486	6226303	90.9815
6499	伊橋	イハシ	75	6486	6226378	90.9826
6500	入部	イリベ	75	6486	6226453	90.9837
6501	遠田	エンタ	75	6486	6226528	90.9848
6502	尾中	オナカ	75	6486	6226603	90.9859
6503	小野辺	オノベ	75	6486	6226678	90.987
6504	男全	オマタ	75	6486	6226753	90.9881
6505	柏倉	カシワグラ	75	6486	6226828	90.9892
6506	片渕	カタブチ	75	6486	6226903	90.9903
6507	川喜田	カワキタ	75	6486	6226978	90.9914
6508	北脇	キタワキ	75	6486	6227053	90.9925
6509	君和田	キミワダ	75	6486	6227128	90.9936
6510	久高	クダカ	75	6486	6227203	90.9947
6511	椚	クヌギ	75	6486	6227278	90.9958
6512	倉又	クラマタ	75	6486	6227353	90.9969
6513	黒瀧	クロタキ	75	6486	6227428	90.998
6514	小早川	コハヤカワ	75	6486	6227503	90.9991
6515	佐久川	サクガワ	75	6486	6227578	91.0002
6516	四釜	シカマ	75	6486	6227653	91.0013
6517	四宮	シミヤ	75	6486	6227728	91.0024
6518	下斗米	シモトマイ	75	6486	6227803	91.0035
6519	白神	シラカミ	75	6486	6227878	91.0046
6520	真貝	シンカイ	75	6486	6227953	91.0057
6521	砂村	スナムラ	75	6486	6228028	91.0068
6522	鷹觜	タカノハシ	75	6486	6228103	91.0078
6523	棚木	タナキ	75	6486	6228178	91.0089
6524	谷島	タニシマ	75	6486	6228253	91.01
6525	田野口	タノグチ	75	6486	6228328	91.0111
6526	坪野	ツボノ	75	6486	6228403	91.0122
6527	時枝	トキエダ	75	6486	6228478	91.0133
6528	鳥本	トリモト	75	6486	6228553	91.0144
6529	二方	フタカタ	75	6486	6228628	91.0155
6530	舟本	フナモト	75	6486	6228703	91.0166
6531	別井	ベツイ	75	6486	6228778	91.0177
6532	星井	ホシイ	75	6486	6228853	91.0188
6533	馬庭	マニワ	75	6486	6228928	91.0199
6534	三隅	ミスミ	75	6486	6229003	91.021
6535	宮古	ミヤコ	75	6486	6229078	91.0221
6536	持永	モチナガ	75	6486	6229153	91.0232
6537	■江	ヨシエ	75	6486	6229228	91.0243
6538	若本	ワカモト	75	6486	6229303	91.0254
6539	赤地	アカチ	74	6539	6229377	91.0265
6540	蟻川	アリカワ	74	6539	6229451	91.0275
6541	今木	イマキ	74	6539	6229525	91.0286
6542	江並	エナミ	74	6539	6229599	91.0297
6543	岡川	オカガワ	74	6539	6229673	91.0308
6544	尾口	オグチ	74	6539	6229747	91.0319
6545	尾林	オバヤシ	74	6539	6229821	91.033
6546	小又	オマタ	74	6539	6229895	91.034
6547	貝田	カイダ	74	6539	6229969	91.0351
6548	抱井	カカイ	74	6539	6230043	91.0362
6549	金塚	カネヅカ	74	6539	6230117	91.0373
6550	蕪木	カブラキ	74	6539	6230191	91.0384
6551	河北	カワキタ	74	6539	6230265	91.0394
6552	河津	カワツ	74	6539	6230339	91.0405
6553	神藤	カンドウ	74	6539	6230413	91.0416
6554	国■	クニヨシ	74	6539	6230487	91.0427
6555	車	クルマ	74	6539	6230561	91.0438
6556	古怒田	コヌタ	74	6539	6230635	91.0448
6557	坂戸	サカト	74	6539	6230709	91.0459
6558	三戸	サンノヘ	74	6539	6230783	91.047
6559	下池	シモイケ	74	6539	6230857	91.0481
6560	真藤	シンドウ	74	6539	6230931	91.0492
6561	実方	ジツカタ	74	6539	6231005	91.0503
6562	陣内	ジンノウチ	74	6539	6231079	91.0513
6563	高師	タカシ	74	6539	6231153	91.0524
6564	■屋	タカヤ	74	6539	6231227	91.0535
6565	大宮司	ダイグウジ	74	6539	6231301	91.0546
6566	千頭和	チズワ	74	6539	6231375	91.0557
6567	常田	ツネダ	74	6539	6231449	91.0567
6568	寺前	テラマエ	74	6539	6231523	91.0578
6569	当山	トウヤマ	74	6539	6231597	91.0589
6570	鳥原	トリハラ	74	6539	6231671	91.06
6571	永■	ナガヨシ	74	6539	6231745	91.0611
6572	七井	ナナイ	74	6539	6231819	91.0621
6573	沼野井	ヌマノイ	74	6539	6231893	91.0632
6574	原島	ハラジマ	74	6539	6231967	91.0643
6575	肱岡	ヒジオカ	74	6539	6232041	91.0654
6576	日比谷	ヒビヤ	74	6539	6232115	91.0665
6577	平中	ヒラナカ	74	6539	6232189	91.0676
6578	文	ブン	74	6539	6232263	91.0686
6579	圓山	マルヤマ	74	6539	6232337	91.0697
6580	水出	ミズイデ	74	6539	6232411	91.0708
6581	三野	ミツノ	74	6539	6232485	91.0719
6582	南舘	ミナミダテ	74	6539	6232559	91.073
6583	嶺井	ミネイ	74	6539	6232633	91.074
6584	六車	ムグルマ	74	6539	6232707	91.0751
6585	村橋	ムラハシ	74	6539	6232781	91.0762
6586	森中	モリナカ	74	6539	6232855	91.0773
6587	守矢	モリヤ	74	6539	6232929	91.0784
6588	■田	ヤブタ	74	6539	6233003	91.0794
6589	柚原	ユハラ	74	6539	6233077	91.0805
6590	渡會	ワタライ	74	6539	6233151	91.0816
6591	飯■	イイタカ	73	6591	6233224	91.0827
6592	猪飼	イカイ	73	6591	6233297	91.0837
6593	井形	イガタ	73	6591	6233370	91.0848
6594	幾田	イクタ	73	6591	6233443	91.0859
6595	池尾	イケオ	73	6591	6233516	91.0869
6596	石見	イシミ	73	6591	6233589	91.088
6597	今川	イマカワ	73	6591	6233662	91.0891
6598	伊牟田	イムタ	73	6591	6233735	91.0901
6599	祝	イワイ	73	6591	6233808	91.0912
6600	大家	オオイエ	73	6591	6233881	91.0923
6601	大菅	オオスガ	73	6591	6233954	91.0933
6602	奥貫	オクヌキ	73	6591	6234027	91.0944
6603	小座間	オザマ	73	6591	6234100	91.0955
6604	押谷	オシタニ	73	6591	6234173	91.0965
6605	乙坂	オトサカ	73	6591	6234246	91.0976
6606	貝原	カイハラ	73	6591	6234319	91.0987
6607	海宝	カイホウ	73	6591	6234392	91.0997
6608	影島	カゲシマ	73	6591	6234465	91.1008
6609	加曽利	カソリ	73	6591	6234538	91.1019
6610	勝井	カツイ	73	6591	6234611	91.1029
6611	金■	カネタカ	73	6591	6234684	91.104
6612	兼村	カネムラ	73	6591	6234757	91.1051
6613	樺島	カバシマ	73	6591	6234830	91.1061
6614	兜森	カブトモリ	73	6591	6234903	91.1072
6615	河江	カワエ	73	6591	6234976	91.1083
6616	我那覇	ガナハ	73	6591	6235049	91.1093
6617	北畑	キタハタ	73	6591	6235122	91.1104
6618	木次	キツギ	73	6591	6235195	91.1115
6619	君嶋	キミシマ	73	6591	6235268	91.1125
6620	国沢	クニサワ	73	6591	6235341	91.1136
6621	蔵方	クラカタ	73	6591	6235414	91.1147
6622	呉	クレ	73	6591	6235487	91.1157
6623	小比類巻	コヒルイマキ	73	6591	6235560	91.1168
6624	小守	コモリ	73	6591	6235633	91.1179
6625	榊田	サカキダ	73	6591	6235706	91.1189
6626	阪野	サカノ	73	6591	6235779	91.12
6627	沢登	サワト	73	6591	6235852	91.1211
6628	澁川	シブカワ	73	6591	6235925	91.1221
6629	城石	シロイシ	73	6591	6235998	91.1232
6630	實川	ジツカワ	73	6591	6236071	91.1243
6631	石	セキ	73	6591	6236144	91.1253
6632	瀬畑	セバタ	73	6591	6236217	91.1264
6633	曽川	ソガワ	73	6591	6236290	91.1275
6634	滝村	タキムラ	73	6591	6236363	91.1285
6635	近山	チカヤマ	73	6591	6236436	91.1296
6636	中馬	チユウマン	73	6591	6236509	91.1307
6637	中■	ナカザキ	73	6591	6236582	91.1317
6638	永谷	ナガヤ	73	6591	6236655	91.1328
6639	奈良原	ナラハラ	73	6591	6236728	91.1339
6640	野嵜	ノザキ	73	6591	6236801	91.1349
6641	野間口	ノマグチ	73	6591	6236874	91.136
6642	畑澤	ハタザワ	73	6591	6236947	91.1371
6643	深草	フカクサ	73	6591	6237020	91.1381
6644	富士	フジ	73	6591	6237093	91.1392
6645	洪	ホン	73	6591	6237166	91.1403
6646	前泊	マエドマリ	73	6591	6237239	91.1413
6647	松口	マツグチ	73	6591	6237312	91.1424
6648	三津谷	ミツヤ	73	6591	6237385	91.1435
6649	守永	モリナガ	73	6591	6237458	91.1445
6650	谷古宇	ヤコウ	73	6591	6237531	91.1456
6651	柳岡	ヤナオカ	73	6591	6237604	91.1467
6652	余川	ヨカワ	73	6591	6237677	91.1477
6653	芳澤	ヨシザワ	73	6591	6237750	91.1488
6654	浅石	アサイシ	72	6654	6237822	91.1499
6655	網谷	アミヤ	72	6654	6237894	91.1509
6656	有元	アリモト	72	6654	6237966	91.152
6657	有■	アリヨシ	72	6654	6238038	91.153
6658	市之瀬	イチノセ	72	6654	6238110	91.1541
6659	于	ウ	72	6654	6238182	91.1551
6660	大桑	オオクワ	72	6654	6238254	91.1562
6661	納	オサメ	72	6654	6238326	91.1572
6662	鬼澤	オニザワ	72	6654	6238398	91.1583
6663	貝森	カイモリ	72	6654	6238470	91.1593
6664	海谷	カイヤ	72	6654	6238542	91.1604
6665	菊谷	キクタニ	72	6654	6238614	91.1614
6666	岸名	キシナ	72	6654	6238686	91.1625
6667	楠見	クスミ	72	6654	6238758	91.1635
6668	粂田	クメタ	72	6654	6238830	91.1646
6669	榑林	クレバヤシ	72	6654	6238902	91.1656
6670	計良	ケラ	72	6654	6238974	91.1667
6671	小勝	コカツ	72	6654	6239046	91.1678
6672	小桧山	コビヤマ	72	6654	6239118	91.1688
6673	駒	コマ	72	6654	6239190	91.1699
6674	坂中	サカナカ	72	6654	6239262	91.1709
6675	酒見	サケミ	72	6654	6239334	91.172
6676	沢藤	サワフジ	72	6654	6239406	91.173
6677	三瓶	サンペ	72	6654	6239478	91.1741
6678	白山	シロヤマ	72	6654	6239550	91.1751
6679	神宮寺	ジングウジ	72	6654	6239622	91.1762
6680	砂子	スナコ	72	6654	6239694	91.1772
6681	関戸	セキト	72	6654	6239766	91.1783
6682	外岡	ソトオカ	72	6654	6239838	91.1793
6683	■下	タカシタ	72	6654	6239910	91.1804
6684	高辻	タカツジ	72	6654	6239982	91.1814
6685	田鎖	タグサリ	72	6654	6240054	91.1825
6686	垂水	タルミ	72	6654	6240126	91.1835
6687	知野	チノ	72	6654	6240198	91.1846
6688	■田	ツチダ	72	6654	6240270	91.1856
6689	伝田	デンダ	72	6654	6240342	91.1867
6690	鳥谷	トリヤ	72	6654	6240414	91.1877
6691	中務	ナカツカサ	72	6654	6240486	91.1888
6692	南郷	ナンゴウ	72	6654	6240558	91.1898
6693	濁川	ニゴリカワ	72	6654	6240630	91.1909
6694	蜂巣	ハチス	72	6654	6240702	91.192
6695	針谷	ハリガイ	72	6654	6240774	91.193
6696	平片	ヒラカタ	72	6654	6240846	91.1941
6697	古村	フルムラ	72	6654	6240918	91.1951
6698	松信	マツノブ	72	6654	6240990	91.1962
6699	松吉	マツヨシ	72	6654	6241062	91.1972
6700	水江	ミズエ	72	6654	6241134	91.1983
6701	迎	ムカイ	72	6654	6241206	91.1993
6702	宗田	ムネタ	72	6654	6241278	91.2004
6703	恵	メグミ	72	6654	6241350	91.2014
6704	盛島	モリシマ	72	6654	6241422	91.2025
6705	安木	ヤスキ	72	6654	6241494	91.2035
6706	八十島	ヤソシマ	72	6654	6241566	91.2046
6707	■住	ヨシズミ	72	6654	6241638	91.2056
6708	芳田	ヨシダ	72	6654	6241710	91.2067
6709	良知	ラチ	72	6654	6241782	91.2077
6710	有園	アリゾノ	71	6710	6241853	91.2088
6711	飯高	イイダカ	71	6710	6241924	91.2098
6712	石曽根	イシソネ	71	6710	6241995	91.2108
6713	一村	イチムラ	71	6710	6242066	91.2119
6714	入船	イリフネ	71	6710	6242137	91.2129
6715	岩附	イワツキ	71	6710	6242208	91.214
6716	江刺	エサシ	71	6710	6242279	91.215
6717	江添	エゾエ	71	6710	6242350	91.216
6718	蛯沢	エビサワ	71	6710	6242421	91.2171
6719	猿渡	エンド	71	6710	6242492	91.2181
6720	大海	オオウミ	71	6710	6242563	91.2191
6721	沖中	オキナカ	71	6710	6242634	91.2202
6722	小國	オグニ	71	6710	6242705	91.2212
6723	押久保	オシクボ	71	6710	6242776	91.2223
6724	掛田	カケダ	71	6710	6242847	91.2233
6725	掛札	カケフダ	71	6710	6242918	91.2243
6726	可知	カチ	71	6710	6242989	91.2254
6727	蟹沢	カニサワ	71	6710	6243060	91.2264
6728	川下	カワシモ	71	6710	6243131	91.2274
6729	川原田	カワラダ	71	6710	6243202	91.2285
6730	岸山	キシヤマ	71	6710	6243273	91.2295
6731	木津	キツ	71	6710	6243344	91.2306
6732	沓間	クツマ	71	6710	6243415	91.2316
6733	栗橋	クリハシ	71	6710	6243486	91.2326
6734	黒子	クロコ	71	6710	6243557	91.2337
6735	粉川	コガワ	71	6710	6243628	91.2347
6736	古敷谷	コシキヤ	71	6710	6243699	91.2357
6737	小波津	コハツ	71	6710	6243770	91.2368
6738	駒林	コマバヤシ	71	6710	6243841	91.2378
6739	小嶺	コミネ	71	6710	6243912	91.2389
6740	済田	サイタ	71	6710	6243983	91.2399
6741	更科	サラシナ	71	6710	6244054	91.2409
6742	篠島	シノジマ	71	6710	6244125	91.242
6743	砂塚	スナヅカ	71	6710	6244196	91.243
6744	反田	ソリタ	71	6710	6244267	91.244
6745	多川	タガワ	71	6710	6244338	91.2451
6746	滝波	タキナミ	71	6710	6244409	91.2461
6747	武江	タケエ	71	6710	6244480	91.2472
6748	竹迫	タケサコ	71	6710	6244551	91.2482
6749	武次	タケツグ	71	6710	6244622	91.2492
6750	武久	タケヒサ	71	6710	6244693	91.2503
6751	立川	タツカワ	71	6710	6244764	91.2513
6752	大丸	ダイマル	71	6710	6244835	91.2523
6753	綱	ツナ	71	6710	6244906	91.2534
6754	津幡	ツバタ	71	6710	6244977	91.2544
6755	程	テイ	71	6710	6245048	91.2555
6756	天願	テンガン	71	6710	6245119	91.2565
6757	富野	トミノ	71	6710	6245190	91.2575
6758	冨安	トミヤス	71	6710	6245261	91.2586
6759	中石	ナカイシ	71	6710	6245332	91.2596
6760	中司	ナカツカサ	71	6710	6245403	91.2606
6761	楡井	ニレイ	71	6710	6245474	91.2617
6762	籏野	ハタノ	71	6710	6245545	91.2627
6763	花園	ハナゾノ	71	6710	6245616	91.2638
6764	■	ハマ	71	6710	6245687	91.2648
6765	早山	ハヤマ	71	6710	6245758	91.2658
6766	樋熊	ヒグマ	71	6710	6245829	91.2669
6767	真栄城	マエシロ	71	6710	6245900	91.2679
6768	間嶋	マジマ	71	6710	6245971	91.2689
6769	松平	マツヒラ	71	6710	6246042	91.27
6770	美和	ミワ	71	6710	6246113	91.271
6771	村重	ムラシゲ	71	6710	6246184	91.2721
6772	村嶋	ムラシマ	71	6710	6246255	91.2731
6773	茂原	モハラ	71	6710	6246326	91.2741
6774	矢倉	ヤグラ	71	6710	6246397	91.2752
6775	藪下	ヤブシタ	71	6710	6246468	91.2762
6776	山門	ヤマカド	71	6710	6246539	91.2772
6777	山家	ヤマガ	71	6710	6246610	91.2783
6778	吉泉	ヨシイズミ	71	6710	6246681	91.2793
6779	米島	ヨネシマ	71	6710	6246752	91.2804
6780	蓬田	ヨモギタ	71	6710	6246823	91.2814
6781	青江	アオエ	70	6781	6246893	91.2824
6782	赤須	アカス	70	6781	6246963	91.2834
6783	安積	アサカ	70	6781	6247033	91.2845
6784	浅輪	アサワ	70	6781	6247103	91.2855
6785	有留	アリトメ	70	6781	6247173	91.2865
6786	有森	アリモリ	70	6781	6247243	91.2875
6787	五十川	イソカワ	70	6781	6247313	91.2886
6788	一井	イチイ	70	6781	6247383	91.2896
6789	井東	イトウ	70	6781	6247453	91.2906
6790	猪原	イハラ	70	6781	6247523	91.2916
6791	岩泉	イワイズミ	70	6781	6247593	91.2926
6792	宇賀	ウガ	70	6781	6247663	91.2937
6793	生形	ウブカタ	70	6781	6247733	91.2947
6794	江坂	エサカ	70	6781	6247803	91.2957
6795	江畠	エバタ	70	6781	6247873	91.2967
6796	大網	オオアミ	70	6781	6247943	91.2978
6797	岡西	オカニシ	70	6781	6248013	91.2988
6798	荻久保	オギクボ	70	6781	6248083	91.2998
6799	尾内	オナイ	70	6781	6248153	91.3008
6800	海田	カイダ	70	6781	6248223	91.3019
6801	角山	カクヤマ	70	6781	6248293	91.3029
6802	梯	カケハシ	70	6781	6248363	91.3039
6803	陰山	カゲヤマ	70	6781	6248433	91.3049
6804	柏村	カシワムラ	70	6781	6248503	91.3059
6805	数野	カズノ	70	6781	6248573	91.307
6806	加世田	カセダ	70	6781	6248643	91.308
6807	金松	カネマツ	70	6781	6248713	91.309
6808	亀ヶ谷	カメガヤ	70	6781	6248783	91.31
6809	菊岡	キクオカ	70	6781	6248853	91.3111
6810	金田一	キンダイチ	70	6781	6248923	91.3121
6811	久須美	クスミ	70	6781	6248993	91.3131
6812	■持	ケンモチ	70	6781	6249063	91.3141
6813	高口	コウグチ	70	6781	6249133	91.3151
6814	越石	コシイシ	70	6781	6249203	91.3162
6815	小鮒	コブナ	70	6781	6249273	91.3172
6816	小俣	コマタ	70	6781	6249343	91.3182
6817	後上	ゴガミ	70	6781	6249413	91.3192
6818	坂村	サカムラ	70	6781	6249483	91.3203
6819	笹渕	ササブチ	70	6781	6249553	91.3213
6820	残間	ザンマ	70	6781	6249623	91.3223
6821	茂原	シゲハラ	70	6781	6249693	91.3233
6822	志野	シノ	70	6781	6249763	91.3244
6823	島山	シマヤマ	70	6781	6249833	91.3254
6824	下釜	シモガマ	70	6781	6249903	91.3264
6825	新出	シンデ	70	6781	6249973	91.3274
6826	末村	スエムラ	70	6781	6250043	91.3284
6827	菅間	スガマ	70	6781	6250113	91.3295
6828	角南	スナミ	70	6781	6250183	91.3305
6829	須之内	スノウチ	70	6781	6250253	91.3315
6830	高砂	タカサゴ	70	6781	6250323	91.3325
6831	■比良	タカヒラ	70	6781	6250393	91.3336
6832	高吉	タカヨシ	70	6781	6250463	91.3346
6833	玉垣	タマガキ	70	6781	6250533	91.3356
6834	大長	ダイチヨウ	70	6781	6250603	91.3366
6835	近内	チカウチ	70	6781	6250673	91.3377
6836	近沢	チカザワ	70	6781	6250743	91.3387
6837	丁	テイ	70	6781	6250813	91.3397
6838	照喜名	テルキナ	70	6781	6250883	91.3407
6839	仲島	ナカジマ	70	6781	6250953	91.3417
6840	長竹	ナガタケ	70	6781	6251023	91.3428
6841	長町	ナガマチ	70	6781	6251093	91.3438
6842	永村	ナガムラ	70	6781	6251163	91.3448
6843	生川	ナルカワ	70	6781	6251233	91.3458
6844	錦	ニシキ	70	6781	6251303	91.3469
6845	半藤	ハンドウ	70	6781	6251373	91.3479
6846	舩山	フナヤマ	70	6781	6251443	91.3489
6847	堀沢	ホリサワ	70	6781	6251513	91.3499
6848	前浜	マエハマ	70	6781	6251583	91.3509
6849	増原	マスハラ	70	6781	6251653	91.352
6850	水上	ミナカミ	70	6781	6251723	91.353
6851	宮北	ミヤキタ	70	6781	6251793	91.354
6852	宮杉	ミヤスギ	70	6781	6251863	91.355
6853	宗像	ムネカタ	70	6781	6251933	91.3561
6854	守安	モリヤス	70	6781	6252003	91.3571
6855	諸沢	モロサワ	70	6781	6252073	91.3581
6856	■田	ヤナギタ	70	6781	6252143	91.3591
6857	山石	ヤマイシ	70	6781	6252213	91.3602
6858	吉丸	ヨシマル	70	6781	6252283	91.3612
6859	與田	ヨダ	70	6781	6252353	91.3622
6860	亘	ワタリ	70	6781	6252423	91.3632
6861	厚地	アツチ	69	6861	6252492	91.3642
6862	安沢	アンザワ	69	6861	6252561	91.3652
6863	井熊	イクマ	69	6861	6252630	91.3662
6864	石居	イシイ	69	6861	6252699	91.3673
6865	一澤	イチサワ	69	6861	6252768	91.3683
6866	出口	イデグチ	69	6861	6252837	91.3693
6867	今澤	イマザワ	69	6861	6252906	91.3703
6868	岩船	イワフネ	69	6861	6252975	91.3713
6869	上森	ウエモリ	69	6861	6253044	91.3723
6870	江渕	エブチ	69	6861	6253113	91.3733
6871	大峰	オオミネ	69	6861	6253182	91.3743
6872	岡内	オカウチ	69	6861	6253251	91.3753
6873	小津	オヅ	69	6861	6253320	91.3763
6874	尾西	オニシ	69	6861	6253389	91.3773
6875	小野村	オノムラ	69	6861	6253458	91.3783
6876	小浜	オバマ	69	6861	6253527	91.3794
6877	笠島	カサジマ	69	6861	6253596	91.3804
6878	桂木	カツラギ	69	6861	6253665	91.3814
6879	金児	カネコ	69	6861	6253734	91.3824
6880	金成	カネナリ	69	6861	6253803	91.3834
6881	金野	カネノ	69	6861	6253872	91.3844
6882	神薗	カミゾノ	69	6861	6253941	91.3854
6883	上平	カミヒラ	69	6861	6254010	91.3864
6884	河原木	カワラギ	69	6861	6254079	91.3874
6885	岸波	キシナミ	69	6861	6254148	91.3884
6886	葛野	クズノ	69	6861	6254217	91.3894
6887	窪野	クボノ	69	6861	6254286	91.3904
6888	倉崎	クラサキ	69	6861	6254355	91.3915
6889	香野	コウノ	69	6861	6254424	91.3925
6890	興梠	コウロギ	69	6861	6254493	91.3935
6891	小堺	コサカイ	69	6861	6254562	91.3945
6892	佐武	サタケ	69	6861	6254631	91.3955
6893	沢内	サワウチ	69	6861	6254700	91.3965
6894	島元	シマモト	69	6861	6254769	91.3975
6895	周東	シユウトウ	69	6861	6254838	91.3985
6896	城内	ジヨウナイ	69	6861	6254907	91.3995
6897	■川	タカガワ	69	6861	6254976	91.4005
6898	武沢	タケザワ	69	6861	6255045	91.4015
6899	武居	タケスエ	69	6861	6255114	91.4025
6900	立野	タチノ	69	6861	6255183	91.4036
6901	帯刀	タテワキ	69	6861	6255252	91.4046
6902	近森	チカモリ	69	6861	6255321	91.4056
6903	月井	ツキイ	69	6861	6255390	91.4066
6904	常岡	ツネオカ	69	6861	6255459	91.4076
6905	永川	ナガカワ	69	6861	6255528	91.4086
6906	長見	ナガミ	69	6861	6255597	91.4096
6907	新里	ニイサト	69	6861	6255666	91.4106
6908	野津	ノツ	69	6861	6255735	91.4116
6909	初瀬川	ハツセガワ	69	6861	6255804	91.4126
6910	馬場	ハバ	69	6861	6255873	91.4136
6911	半場	ハンバ	69	6861	6255942	91.4146
6912	藤家	フジイエ	69	6861	6256011	91.4157
6913	堀金	ホリガネ	69	6861	6256080	91.4167
6914	本望	ホンモウ	69	6861	6256149	91.4177
6915	前原	マエバラ	69	6861	6256218	91.4187
6916	馬越	マゴシ	69	6861	6256287	91.4197
6917	真砂	マサゴ	69	6861	6256356	91.4207
6918	舛水	マスミズ	69	6861	6256425	91.4217
6919	松久保	マツクボ	69	6861	6256494	91.4227
6920	湊谷	ミナトヤ	69	6861	6256563	91.4237
6921	御代田	ミヨタ	69	6861	6256632	91.4247
6922	銘苅	メカル	69	6861	6256701	91.4257
6923	元橋	モトハシ	69	6861	6256770	91.4267
6924	横松	ヨコマツ	69	6861	6256839	91.4278
6925	愛川	アイカワ	68	6925	6256907	91.4287
6926	赤見	アカミ	68	6925	6256975	91.4297
6927	赤峰	アカミネ	68	6925	6257043	91.4307
6928	秋村	アキムラ	68	6925	6257111	91.4317
6929	浅子	アサコ	68	6925	6257179	91.4327
6930	荒生	アラオ	68	6925	6257247	91.4337
6931	新城	アラシロ	68	6925	6257315	91.4347
6932	泉澤	イズミサワ	68	6925	6257383	91.4357
6933	井芹	イセリ	68	6925	6257451	91.4367
6934	礒貝	イソガイ	68	6925	6257519	91.4377
6935	今道	イマミチ	68	6925	6257587	91.4387
6936	馬越	ウマコシ	68	6925	6257655	91.4397
6937	梅岡	ウメオカ	68	6925	6257723	91.4407
6938	ト部	ウラベ	68	6925	6257791	91.4417
6939	上野	ウワノ	68	6925	6257859	91.4427
6940	扇	オオギ	68	6925	6257927	91.4437
6941	大和	オオワ	68	6925	6257995	91.4446
6942	小川原	オガワラ	68	6925	6258063	91.4456
6943	斧田	オノダ	68	6925	6258131	91.4466
6944	加嶋	カシマ	68	6925	6258199	91.4476
6945	数井	カズイ	68	6925	6258267	91.4486
6946	加勢	カセ	68	6925	6258335	91.4496
6947	門川	カドカワ	68	6925	6258403	91.4506
6948	上柳	カミヤナギ	68	6925	6258471	91.4516
6949	亀倉	カメクラ	68	6925	6258539	91.4526
6950	河原井	カワライ	68	6925	6258607	91.4536
6951	釘本	クギモト	68	6925	6258675	91.4546
6952	九里	クノリ	68	6925	6258743	91.4556
6953	久保倉	クボクラ	68	6925	6258811	91.4566
6954	久山	クヤマ	68	6925	6258879	91.4576
6955	倉元	クラモト	68	6925	6258947	91.4586
6956	蔵元	クラモト	68	6925	6259015	91.4595
6957	黒住	クロズミ	68	6925	6259083	91.4605
6958	小井戸	コイド	68	6925	6259151	91.4615
6959	鴻池	コウノイケ	68	6925	6259219	91.4625
6960	小畠	コバタケ	68	6925	6259287	91.4635
6961	榮	サカエ	68	6925	6259355	91.4645
6962	笹嶋	ササジマ	68	6925	6259423	91.4655
6963	篠本	シノモト	68	6925	6259491	91.4665
6964	新橋	シンバシ	68	6925	6259559	91.4675
6965	束原	ツカハラ	68	6925	6259627	91.4685
6966	徳満	トクミツ	68	6925	6259695	91.4695
6967	豊里	トヨサト	68	6925	6259763	91.4705
6968	名城	ナシロ	68	6925	6259831	91.4715
6969	西松	ニシマツ	68	6925	6259899	91.4725
6970	野寺	ノデラ	68	6925	6259967	91.4735
6971	蓮実	ハスミ	68	6925	6260035	91.4745
6972	浜畑	ハマハタ	68	6925	6260103	91.4754
6973	久村	ヒサムラ	68	6925	6260171	91.4764
6974	馬込	マゴメ	68	6925	6260239	91.4774
6975	正田	マサダ	68	6925	6260307	91.4784
6976	馬嶋	マジマ	68	6925	6260375	91.4794
6977	三次	ミツギ	68	6925	6260443	91.4804
6978	港	ミナト	68	6925	6260511	91.4814
6979	麦島	ムギシマ	68	6925	6260579	91.4824
6980	湯村	ユムラ	68	6925	6260647	91.4834
6981	吉垣	ヨシガキ	68	6925	6260715	91.4844
6982	吉竹	ヨシタケ	68	6925	6260783	91.4854
6983	吉平	ヨシヒラ	68	6925	6260851	91.4864
6984	■水	ヨシミズ	68	6925	6260919	91.4874
6985	淺井	アサイ	67	6985	6260986	91.4883
6986	我妻	アズマ	67	6985	6261053	91.4893
6987	穴原	アナハラ	67	6985	6261120	91.4903
6988	網中	アミナカ	67	6985	6261187	91.4913
6989	綾野	アヤノ	67	6985	6261254	91.4923
6990	出水	イズミ	67	6985	6261321	91.4932
6991	五日市	イツカイチ	67	6985	6261388	91.4942
6992	稲野辺	イナノベ	67	6985	6261455	91.4952
6993	猪岡	イノオカ	67	6985	6261522	91.4962
6994	上里	ウエザト	67	6985	6261589	91.4972
6995	内木	ウチキ	67	6985	6261656	91.4981
6996	卯野	ウノ	67	6985	6261723	91.4991
6997	大部	オオブ	67	6985	6261790	91.5001
6998	大峯	オオミネ	67	6985	6261857	91.5011
6999	奥園	オクゾノ	67	6985	6261924	91.5021
7000	小谷	オダニ	67	6985	6261991	91.503
7001	尾原	オバラ	67	6985	6262058	91.504
7002	鍛冶	カジ	67	6985	6262125	91.505
7003	甲木	カツキ	67	6985	6262192	91.506
7004	金重	カネシゲ	67	6985	6262259	91.507
7005	嘉納	カノウ	67	6985	6262326	91.5079
7006	北上	キタカミ	67	6985	6262393	91.5089
7007	木戸口	キドグチ	67	6985	6262460	91.5099
7008	久津間	クツマ	67	6985	6262527	91.5109
7009	久米田	クメタ	67	6985	6262594	91.5118
7010	小原	コバラ	67	6985	6262661	91.5128
7011	小渕	コブチ	67	6985	6262728	91.5138
7012	犀川	サイカワ	67	6985	6262795	91.5148
7013	西藤	サイトウ	67	6985	6262862	91.5158
7014	重政	シゲマサ	67	6985	6262929	91.5167
7015	篠塚	シノズカ	67	6985	6262996	91.5177
7016	四ノ宮	シノミヤ	67	6985	6263063	91.5187
7017	新木	シンキ	67	6985	6263130	91.5197
7018	新郷	シンゴウ	67	6985	6263197	91.5207
7019	外崎	ソトザキ	67	6985	6263264	91.5216
7020	田形	タガタ	67	6985	6263331	91.5226
7021	武中	タケナカ	67	6985	6263398	91.5236
7022	玉澤	タマザワ	67	6985	6263465	91.5246
7023	民谷	タミヤ	67	6985	6263532	91.5256
7024	土子	ツチコ	67	6985	6263599	91.5265
7025	綱木	ツナキ	67	6985	6263666	91.5275
7026	渡慶次	トケシ	67	6985	6263733	91.5285
7027	外池	トノイケ	67	6985	6263800	91.5295
7028	友常	トモツネ	67	6985	6263867	91.5304
7029	名田	ナダ	67	6985	6263934	91.5314
7030	浪江	ナミエ	67	6985	6264001	91.5324
7031	新垣	ニイガキ	67	6985	6264068	91.5334
7032	鳩山	ハトヤマ	67	6985	6264135	91.5344
7033	早水	ハヤミズ	67	6985	6264202	91.5353
7034	氷見	ヒミ	67	6985	6264269	91.5363
7035	兵庫	ヒヨウゴ	67	6985	6264336	91.5373
7036	藤塚	フジヅカ	67	6985	6264403	91.5383
7037	二葉	フタバ	67	6985	6264470	91.5393
7038	宝子山	ホウシヤマ	67	6985	6264537	91.5402
7039	保志	ホシ	67	6985	6264604	91.5412
7040	曲渕	マガリブチ	67	6985	6264671	91.5422
7041	正野	マサノ	67	6985	6264738	91.5432
7042	間庭	マニワ	67	6985	6264805	91.5442
7043	宗岡	ムネオカ	67	6985	6264872	91.5451
7044	■浦	ヨシウラ	67	6985	6264939	91.5461
7045	吉開	ヨシカイ	67	6985	6265006	91.5471
7046	■原	ヨシワラ	67	6985	6265073	91.5481
7047	赤上	アカガミ	66	7047	6265139	91.549
7048	安形	アガタ	66	7047	6265205	91.55
7049	朝木	アサキ	66	7047	6265271	91.551
7050	蘭	アララギ	66	7047	6265337	91.5519
7051	安徳	アントク	66	7047	6265403	91.5529
7052	池添	イケゾエ	66	7047	6265469	91.5539
7053	磯目	イソメ	66	7047	6265535	91.5548
7054	糸田	イトダ	66	7047	6265601	91.5558
7055	猪鼻	イノハナ	66	7047	6265667	91.5568
7056	今永	イマナガ	66	7047	6265733	91.5577
7057	上嶋	ウエジマ	66	7047	6265799	91.5587
7058	内尾	ウチオ	66	7047	6265865	91.5596
7059	江利川	エリカワ	66	7047	6265931	91.5606
7060	大磯	オオイソ	66	7047	6265997	91.5616
7061	大東	オオヒガシ	66	7047	6266063	91.5625
7062	勝谷	カツヤ	66	7047	6266129	91.5635
7063	鐘ヶ江	カネガエ	66	7047	6266195	91.5645
7064	木我	キガ	66	7047	6266261	91.5654
7065	北詰	キタヅメ	66	7047	6266327	91.5664
7066	喜多見	キタミ	66	7047	6266393	91.5674
7067	木野内	キノウチ	66	7047	6266459	91.5683
7068	久保村	クボムラ	66	7047	6266525	91.5693
7069	黒津	クロツ	66	7047	6266591	91.5703
7070	肥沼	コイヌマ	66	7047	6266657	91.5712
7071	神田	コウダ	66	7047	6266723	91.5722
7072	小賀坂	コガサカ	66	7047	6266789	91.5731
7073	佐井	サイ	66	7047	6266855	91.5741
7074	西塔	サイトウ	66	7047	6266921	91.5751
7075	榊枝	サカキエダ	66	7047	6266987	91.576
7076	坂手	サカテ	66	7047	6267053	91.577
7077	崎村	サキムラ	66	7047	6267119	91.578
7078	桜場	サクラバ	66	7047	6267185	91.5789
7079	志方	シカタ	66	7047	6267251	91.5799
7080	芝岡	シバオカ	66	7047	6267317	91.5809
7081	柴谷	シバタニ	66	7047	6267383	91.5818
7082	下瀬	シモセ	66	7047	6267449	91.5828
7083	新原	シンバラ	66	7047	6267515	91.5838
7084	末安	スエヤス	66	7047	6267581	91.5847
7085	首藤	スドウ	66	7047	6267647	91.5857
7086	強矢	スネヤ	66	7047	6267713	91.5866
7087	隅	スミ	66	7047	6267779	91.5876
7088	滝沢	タキサワ	66	7047	6267845	91.5886
7089	田鎖	タクサリ	66	7047	6267911	91.5895
7090	竹間	タケマ	66	7047	6267977	91.5905
7091	知名	チナ	66	7047	6268043	91.5915
7092	妻沼	ツマヌマ	66	7047	6268109	91.5924
7093	寺園	テラゾノ	66	7047	6268175	91.5934
7094	渡口	トグチ	66	7047	6268241	91.5944
7095	外村	トノムラ	66	7047	6268307	91.5953
7096	飛内	トビナイ	66	7047	6268373	91.5963
7097	富	トミ	66	7047	6268439	91.5973
7098	中家	ナカイエ	66	7047	6268505	91.5982
7099	中松	ナカマツ	66	7047	6268571	91.5992
7100	永易	ナガヤス	66	7047	6268637	91.6001
7101	生江	ナマエ	66	7047	6268703	91.6011
7102	西郡	ニシゴオリ	66	7047	6268769	91.6021
7103	二橋	ニハシ	66	7047	6268835	91.603
7104	根建	ネダテ	66	7047	6268901	91.604
7105	原岡	ハラオカ	66	7047	6268967	91.605
7106	日山	ヒヤマ	66	7047	6269033	91.6059
7107	吹上	フキアゲ	66	7047	6269099	91.6069
7108	船倉	フナクラ	66	7047	6269165	91.6079
7109	邊見	ヘンミ	66	7047	6269231	91.6088
7110	真栄田	マエダ	66	7047	6269297	91.6098
7111	柾谷	マサヤ	66	7047	6269363	91.6108
7112	道村	ミチムラ	66	7047	6269429	91.6117
7113	本谷	モトヤ	66	7047	6269495	91.6127
7114	楊	ヤン	66	7047	6269561	91.6137
7115	淀川	ヨドガワ	66	7047	6269627	91.6146
7116	米長	ヨネナガ	66	7047	6269693	91.6156
7117	六角	ロツカク	66	7047	6269759	91.6165
7118	後村	アトムラ	65	7118	6269824	91.6175
7119	荒屋	アラヤ	65	7118	6269889	91.6184
7120	池島	イケシマ	65	7118	6269954	91.6194
7121	伊敷	イシキ	65	7118	6270019	91.6203
7122	一山	イチヤマ	65	7118	6270084	91.6213
7123	居山	イヤマ	65	7118	6270149	91.6222
7124	宇内	ウナイ	65	7118	6270214	91.6232
7125	海川	ウミカワ	65	7118	6270279	91.6241
7126	漆間	ウルマ	65	7118	6270344	91.6251
7127	柿山	カキヤマ	65	7118	6270409	91.626
7128	樫尾	カシオ	65	7118	6270474	91.627
7129	勝川	カツカワ	65	7118	6270539	91.6279
7130	鎌滝	カマタキ	65	7118	6270604	91.6289
7131	亀本	カメモト	65	7118	6270669	91.6298
7132	川辺	カワナベ	65	7118	6270734	91.6308
7133	漢那	カンナ	65	7118	6270799	91.6317
7134	菊山	キクヤマ	65	7118	6270864	91.6327
7135	■川	キツカワ	65	7118	6270929	91.6336
7136	國見	クニミ	65	7118	6270994	91.6346
7137	倉茂	クラシゲ	65	7118	6271059	91.6355
7138	湖上	コガミ	65	7118	6271124	91.6365
7139	小塚	コズカ	65	7118	6271189	91.6374
7140	根田	コンダ	65	7118	6271254	91.6384
7141	合志	ゴウシ	65	7118	6271319	91.6393
7142	郷内	ゴウナイ	65	7118	6271384	91.6403
7143	齊木	サイキ	65	7118	6271449	91.6412
7144	斎田	サイダ	65	7118	6271514	91.6422
7145	坂井田	サカイダ	65	7118	6271579	91.6431
7146	坂脇	サカワキ	65	7118	6271644	91.6441
7147	澤登	サワノボリ	65	7118	6271709	91.645
7148	沢柳	サワヤナギ	65	7118	6271774	91.646
7149	嶋根	シマネ	65	7118	6271839	91.6469
7150	下倉	シモクラ	65	7118	6271904	91.6479
7151	新福	シンプク	65	7118	6271969	91.6488
7152	城倉	ジヨウクラ	65	7118	6272034	91.6498
7153	滝原	タキハラ	65	7118	6272099	91.6507
7154	武林	タケバヤシ	65	7118	6272164	91.6517
7155	立沢	タツザワ	65	7118	6272229	91.6526
7156	田母神	タモガミ	65	7118	6272294	91.6536
7157	保	タモツ	65	7118	6272359	91.6545
7158	大楽	ダイラク	65	7118	6272424	91.6555
7159	戸栗	トグリ	65	7118	6272489	91.6564
7160	都甲	トコウ	65	7118	6272554	91.6574
7161	飛松	トビマツ	65	7118	6272619	91.6583
7162	冨松	トミマツ	65	7118	6272684	91.6593
7163	仲林	ナカバヤシ	65	7118	6272749	91.6602
7164	長村	ナガムラ	65	7118	6272814	91.6612
7165	名執	ナトリ	65	7118	6272879	91.6621
7166	鍋嶋	ナベシマ	65	7118	6272944	91.6631
7167	生天目	ナマタメ	65	7118	6273009	91.664
7168	楢崎	ナラザキ	65	7118	6273074	91.665
7169	楢山	ナラヤマ	65	7118	6273139	91.6659
7170	新部	ニイベ	65	7118	6273204	91.6669
7171	能城	ノウジヨウ	65	7118	6273269	91.6678
7172	野手	ノテ	65	7118	6273334	91.6688
7173	橋倉	ハシクラ	65	7118	6273399	91.6697
7174	蓮井	ハスイ	65	7118	6273464	91.6707
7175	■野	ハマノ	65	7118	6273529	91.6716
7176	林下	ハヤシシタ	65	7118	6273594	91.6726
7177	平下	ヒラシタ	65	7118	6273659	91.6735
7178	広山	ヒロヤマ	65	7118	6273724	91.6745
7179	渕本	フチモト	65	7118	6273789	91.6754
7180	保崎	ホサキ	65	7118	6273854	91.6764
7181	真家	マイエ	65	7118	6273919	91.6773
7182	枡田	マスダ	65	7118	6273984	91.6783
7183	松阪	マツザカ	65	7118	6274049	91.6792
7184	水鳥	ミズトリ	65	7118	6274114	91.6802
7185	源川	ミナガワ	65	7118	6274179	91.6811
7186	都	ミヤコ	65	7118	6274244	91.6821
7187	宮迫	ミヤサコ	65	7118	6274309	91.683
7188	森松	モリマツ	65	7118	6274374	91.684
7189	矢花	ヤバナ	65	7118	6274439	91.6849
7190	吉羽	ヨシバ	65	7118	6274504	91.6859
7191	相見	アイミ	64	7191	6274568	91.6868
7192	明松	アケマツ	64	7191	6274632	91.6878
7193	吾妻	アズマ	64	7191	6274696	91.6887
7194	有水	アリミズ	64	7191	6274760	91.6896
7195	飯坂	イイザカ	64	7191	6274824	91.6906
7196	伊崎	イザキ	64	7191	6274888	91.6915
7197	石母田	イシモダ	64	7191	6274952	91.6924
7198	出浦	イデウラ	64	7191	6275016	91.6934
7199	今別府	イマベツプ	64	7191	6275080	91.6943
7200	入谷	イリヤ	64	7191	6275144	91.6952
7201	浦口	ウラグチ	64	7191	6275208	91.6962
7202	浦中	ウラナカ	64	7191	6275272	91.6971
7203	恵良	エラ	64	7191	6275336	91.698
7204	大芦	オオアシ	64	7191	6275400	91.699
7205	大葉	オオバ	64	7191	6275464	91.6999
7206	尾上	オガミ	64	7191	6275528	91.7008
7207	荻沼	オギヌマ	64	7191	6275592	91.7018
7208	奥薗	オクゾノ	64	7191	6275656	91.7027
7209	小名木	オナギ	64	7191	6275720	91.7036
7210	小村	オムラ	64	7191	6275784	91.7046
7211	園曽	オンソ	64	7191	6275848	91.7055
7212	御守	オンモリ	64	7191	6275912	91.7065
7213	籠島	カゴシマ	64	7191	6275976	91.7074
7214	柏葉	カシワバ	64	7191	6276040	91.7083
7215	片貝	カタガイ	64	7191	6276104	91.7093
7216	嘉陽	カヨウ	64	7191	6276168	91.7102
7217	川中子	カワナゴ	64	7191	6276232	91.7111
7218	木梨	キナシ	64	7191	6276296	91.7121
7219	絹川	キヌカワ	64	7191	6276360	91.713
7220	国光	クニミツ	64	7191	6276424	91.7139
7221	小管	コスゲ	64	7191	6276488	91.7149
7222	佐沢	サザワ	64	7191	6276552	91.7158
7223	四家	シケ	64	7191	6276616	91.7167
7224	嶋津	シマズ	64	7191	6276680	91.7177
7225	下地	シモヂ	64	7191	6276744	91.7186
7226	関上	セキガミ	64	7191	6276808	91.7195
7227	全	ゼン	64	7191	6276872	91.7205
7228	左右田	ソウダ	64	7191	6276936	91.7214
7229	■浦	タカウラ	64	7191	6277000	91.7224
7230	高澤	タカサワ	64	7191	6277064	91.7233
7231	高槻	タカツキ	64	7191	6277128	91.7242
7232	高堂	タカドウ	64	7191	6277192	91.7252
7233	■波	タカナミ	64	7191	6277256	91.7261
7234	滝浦	タキウラ	64	7191	6277320	91.727
7235	田嶋	タシマ	64	7191	6277384	91.728
7236	只木	タダキ	64	7191	6277448	91.7289
7237	谷畑	タニハタ	64	7191	6277512	91.7298
7238	塚口	ツカグチ	64	7191	6277576	91.7308
7239	蔦木	ツタキ	64	7191	6277640	91.7317
7240	妻木	ツマキ	64	7191	6277704	91.7326
7241	鶴園	ツルゾノ	64	7191	6277768	91.7336
7242	出山	デヤマ	64	7191	6277832	91.7345
7243	中野目	ナカノメ	64	7191	6277896	91.7354
7244	永池	ナガイケ	64	7191	6277960	91.7364
7245	長嶌	ナガシマ	64	7191	6278024	91.7373
7246	七澤	ナナサワ	64	7191	6278088	91.7383
7247	楢木	ナラキ	64	7191	6278152	91.7392
7248	新沢	ニイザワ	64	7191	6278216	91.7401
7249	二色	ニシキ	64	7191	6278280	91.7411
7250	錦織	ニシコオリ	64	7191	6278344	91.742
7251	野毛	ノゲ	64	7191	6278408	91.7429
7252	浜屋	ハマヤ	64	7191	6278472	91.7439
7253	針谷	ハリガヤ	64	7191	6278536	91.7448
7254	日向寺	ヒユウガジ	64	7191	6278600	91.7457
7255	平谷	ヒラタニ	64	7191	6278664	91.7467
7256	牧本	マキモト	64	7191	6278728	91.7476
7257	益満	マスミツ	64	7191	6278792	91.7485
7258	町屋	マチヤ	64	7191	6278856	91.7495
7259	皆見	ミナミ	64	7191	6278920	91.7504
7260	村口	ムラグチ	64	7191	6278984	91.7513
7261	森林	モリバヤシ	64	7191	6279048	91.7523
7262	屋城	ヤシロ	64	7191	6279112	91.7532
7263	叶	ヨウ	64	7191	6279176	91.7542
7264	米内山	ヨナイヤマ	64	7191	6279240	91.7551
7265	亘理	ワタリ	64	7191	6279304	91.756
7266	藁品	ワラシナ	64	7191	6279368	91.757
7267	阿多	アタ	63	7267	6279431	91.7579
7268	畔蒜	アビル	63	7267	6279494	91.7588
7269	雨貝	アマガイ	63	7267	6279557	91.7597
7270	天木	アマキ	63	7267	6279620	91.7606
7271	安在	アンザイ	63	7267	6279683	91.7616
7272	飯吉	イイヨシ	63	7267	6279746	91.7625
7273	石和田	イシワダ	63	7267	6279809	91.7634
7274	稲留	イナドメ	63	7267	6279872	91.7643
7275	巌	イワオ	63	7267	6279935	91.7652
7276	上嶋	ウエシマ	63	7267	6279998	91.7662
7277	宇敷	ウシキ	63	7267	6280061	91.7671
7278	岡垣	オカガキ	63	7267	6280124	91.768
7279	尾作	オサク	63	7267	6280187	91.7689
7280	小田野	オダノ	63	7267	6280250	91.7698
7281	海津	カイズ	63	7267	6280313	91.7708
7282	角和	カクワ	63	7267	6280376	91.7717
7283	蒲地	カマチ	63	7267	6280439	91.7726
7284	神取	カミトリ	63	7267	6280502	91.7735
7285	鴨居	カモイ	63	7267	6280565	91.7744
7286	吉川	キチカワ	63	7267	6280628	91.7754
7287	木幡	キハタ	63	7267	6280691	91.7763
7288	黒宮	クロミヤ	63	7267	6280754	91.7772
7289	計良	ケイラ	63	7267	6280817	91.7781
7290	越智	コエチ	63	7267	6280880	91.779
7291	小甲	コカブ	63	7267	6280943	91.78
7292	権	ゴン	63	7267	6281006	91.7809
7293	匂坂	サギサカ	63	7267	6281069	91.7818
7294	桜岡	サクラオカ	63	7267	6281132	91.7827
7295	提箸	サゲハシ	63	7267	6281195	91.7837
7296	菅本	スガモト	63	7267	6281258	91.7846
7297	薄	ススキ	63	7267	6281321	91.7855
7298	住野	スミノ	63	7267	6281384	91.7864
7299	先■	センザキ	63	7267	6281447	91.7873
7300	仙道	センドウ	63	7267	6281510	91.7883
7301	早乙女	ソウトメ	63	7267	6281573	91.7892
7302	■良	タカラ	63	7267	6281636	91.7901
7303	瀧野	タキノ	63	7267	6281699	91.791
7304	竹垣	タケガキ	63	7267	6281762	91.7919
7305	立崎	タチザキ	63	7267	6281825	91.7929
7306	田屋	タヤ	63	7267	6281888	91.7938
7307	大道寺	ダイドウジ	63	7267	6281951	91.7947
7308	茅原	チハラ	63	7267	6282014	91.7956
7309	■田	ツルタ	63	7267	6282077	91.7965
7310	鶴間	ツルマ	63	7267	6282140	91.7975
7311	徳留	トクトメ	63	7267	6282203	91.7984
7312	床井	トコイ	63	7267	6282266	91.7993
7313	外村	トムラ	63	7267	6282329	91.8002
7314	名嘉真	ナカマ	63	7267	6282392	91.8011
7315	永橋	ナガハシ	63	7267	6282455	91.8021
7316	野副	ノゾエ	63	7267	6282518	91.803
7317	野寄	ノヨリ	63	7267	6282581	91.8039
7318	畑村	ハタムラ	63	7267	6282644	91.8048
7319	藤城	フジキ	63	7267	6282707	91.8057
7320	普天間	フテンマ	63	7267	6282770	91.8067
7321	冬木	フユキ	63	7267	6282833	91.8076
7322	古郡	フルゴウリ	63	7267	6282896	91.8085
7323	本所	ホンジヨ	63	7267	6282959	91.8094
7324	増谷	マスタニ	63	7267	6283022	91.8103
7325	増元	マスモト	63	7267	6283085	91.8113
7326	光野	ミツノ	63	7267	6283148	91.8122
7327	峰島	ミネシマ	63	7267	6283211	91.8131
7328	宮岸	ミヤギシ	63	7267	6283274	91.814
7329	毛木	モギ	63	7267	6283337	91.815
7330	盛永	モリナガ	63	7267	6283400	91.8159
7331	安島	ヤスジマ	63	7267	6283463	91.8168
7332	八住	ヤスミ	63	7267	6283526	91.8177
7333	山方	ヤマガタ	63	7267	6283589	91.8186
7334	山極	ヤマギワ	63	7267	6283652	91.8196
7335	与座	ヨザ	63	7267	6283715	91.8205
7336	義沢	ヨシザワ	63	7267	6283778	91.8214
7337	吉光	ヨシミツ	63	7267	6283841	91.8223
7338	吾郷	アゴウ	62	7338	6283903	91.8232
7339	尼子	アマコ	62	7338	6283965	91.8241
7340	生井	イクイ	62	7338	6284027	91.825
7341	池杉	イケスギ	62	7338	6284089	91.8259
7342	石巻	イシマキ	62	7338	6284151	91.8268
7343	礒辺	イソベ	62	7338	6284213	91.8278
7344	井畑	イバタ	62	7338	6284275	91.8287
7345	岩立	イワタテ	62	7338	6284337	91.8296
7346	内橋	ウチハシ	62	7338	6284399	91.8305
7347	江渡	エト	62	7338	6284461	91.8314
7348	扇	オウギ	62	7338	6284523	91.8323
7349	大川内	オオカワチ	62	7338	6284585	91.8332
7350	小柳津	オヤイヅ	62	7338	6284647	91.8341
7351	角谷	カクヤ	62	7338	6284709	91.835
7352	■山	カゲヤマ	62	7338	6284771	91.8359
7353	柏井	カシワイ	62	7338	6284833	91.8368
7354	上遠野	カドノ	62	7338	6284895	91.8377
7355	瓦井	カワライ	62	7338	6284957	91.8386
7356	鬼沢	キザワ	62	7338	6285019	91.8395
7357	岸浪	キシナミ	62	7338	6285081	91.8404
7358	木代	キシロ	62	7338	6285143	91.8413
7359	北中	キタナカ	62	7338	6285205	91.8422
7360	汲田	クミタ	62	7338	6285267	91.8432
7361	鍬田	クワタ	62	7338	6285329	91.8441
7362	小城	コシロ	62	7338	6285391	91.845
7363	小鹿	コジカ	62	7338	6285453	91.8459
7364	小畑	コバタ	62	7338	6285515	91.8468
7365	小曲	コマガリ	62	7338	6285577	91.8477
7366	鷺	サギ	62	7338	6285639	91.8486
7367	佐々田	ササダ	62	7338	6285701	91.8495
7368	佐々	サツサ	62	7338	6285763	91.8504
7369	里中	サトナカ	62	7338	6285825	91.8513
7370	佐土原	サドハラ	62	7338	6285887	91.8522
7371	塩尻	シオジリ	62	7338	6285949	91.8531
7372	志垣	シガキ	62	7338	6286011	91.854
7373	篠澤	シノザワ	62	7338	6286073	91.8549
7374	下間	シモマ	62	7338	6286135	91.8558
7375	白髭	シラヒゲ	62	7338	6286197	91.8567
7376	末原	スエハラ	62	7338	6286259	91.8577
7377	末本	スエモト	62	7338	6286321	91.8586
7378	杉坂	スギサカ	62	7338	6286383	91.8595
7379	須崎	スサキ	62	7338	6286445	91.8604
7380	炭谷	スミタニ	62	7338	6286507	91.8613
7381	關	セキ	62	7338	6286569	91.8622
7382	園原	ソノハラ	62	7338	6286631	91.8631
7383	高谷	タカタニ	62	7338	6286693	91.864
7384	田賀	タガ	62	7338	6286755	91.8649
7385	瀧井	タキイ	62	7338	6286817	91.8658
7386	武谷	タケヤ	62	7338	6286879	91.8667
7387	田名部	タナベ	62	7338	6286941	91.8676
7388	玉江	タマエ	62	7338	6287003	91.8685
7389	玉沢	タマザワ	62	7338	6287065	91.8694
7390	玉谷	タマタニ	62	7338	6287127	91.8703
7391	玉谷	タマヤ	62	7338	6287189	91.8712
7392	続	ツヅキ	62	7338	6287251	91.8721
7393	津波	ツハ	62	7338	6287313	91.8731
7394	天童	テンドウ	62	7338	6287375	91.874
7395	杜	ト	62	7338	6287437	91.8749
7396	徳富	トクトミ	62	7338	6287499	91.8758
7397	飛澤	トビサワ	62	7338	6287561	91.8767
7398	豊沢	トヨサワ	62	7338	6287623	91.8776
7399	鳥丸	トリマル	62	7338	6287685	91.8785
7400	中屋敷	ナカヤシキ	62	7338	6287747	91.8794
7401	永戸	ナガト	62	7338	6287809	91.8803
7402	西家	ニシイエ	62	7338	6287871	91.8812
7403	韮山	ニラヤマ	62	7338	6287933	91.8821
7404	野田頭	ノダガシラ	62	7338	6287995	91.883
7405	野月	ノヅキ	62	7338	6288057	91.8839
7406	■島	ハイジマ	62	7338	6288119	91.8848
7407	濱島	ハマシマ	62	7338	6288181	91.8857
7408	日笠	ヒガサ	62	7338	6288243	91.8866
7409	比屋根	ヒヤネ	62	7338	6288305	91.8875
7410	平居	ヒライ	62	7338	6288367	91.8885
7411	福江	フクエ	62	7338	6288429	91.8894
7412	舩津	フナツ	62	7338	6288491	91.8903
7413	布野	フノ	62	7338	6288553	91.8912
7414	前迫	マエサコ	62	7338	6288615	91.8921
7415	前里	マエサト	62	7338	6288677	91.893
7416	三雲	ミクモ	62	7338	6288739	91.8939
7417	水上	ミズガミ	62	7338	6288801	91.8948
7418	見田	ミタ	62	7338	6288863	91.8957
7419	三矢	ミツヤ	62	7338	6288925	91.8966
7420	満山	ミツヤマ	62	7338	6288987	91.8975
7421	三苫	ミトマ	62	7338	6289049	91.8984
7422	峰野	ミネノ	62	7338	6289111	91.8993
7423	茂田井	モタイ	62	7338	6289173	91.9002
7424	森江	モリエ	62	7338	6289235	91.9011
7425	谷貝	ヤガイ	62	7338	6289297	91.902
7426	谷田川	ヤタガワ	62	7338	6289359	91.9029
7427	山出	ヤマデ	62	7338	6289421	91.9039
7428	山野内	ヤマノウチ	62	7338	6289483	91.9048
7429	横谷	ヨコタニ	62	7338	6289545	91.9057
7430	■垣	ヨシガキ	62	7338	6289607	91.9066
7431	与田	ヨダ	62	7338	6289669	91.9075
7432	米丸	ヨネマル	62	7338	6289731	91.9084
7433	依田	ヨリタ	62	7338	6289793	91.9093
7434	柳	リユウ	62	7338	6289855	91.9102
7435	若目田	ワカメダ	62	7338	6289917	91.9111
7436	相本	アイモト	61	7436	6289978	91.912
7437	明間	アケマ	61	7436	6290039	91.9129
7438	厚木	アツギ	61	7436	6290100	91.9138
7439	天辰	アマタツ	61	7436	6290161	91.9147
7440	石嶺	イシミネ	61	7436	6290222	91.9156
7441	一宮	イチノミヤ	61	7436	6290283	91.9165
7442	稲原	イナハラ	61	7436	6290344	91.9173
7443	岩藤	イワフジ	61	7436	6290405	91.9182
7444	大井田	オオイダ	61	7436	6290466	91.9191
7445	大信田	オオシダ	61	7436	6290527	91.92
7446	奥西	オクニシ	61	7436	6290588	91.9209
7447	柏柳	カシワヤナギ	61	7436	6290649	91.9218
7448	梶塚	カジヅカ	61	7436	6290710	91.9227
7449	片渕	カタフチ	61	7436	6290771	91.9236
7450	金崎	カネサキ	61	7436	6290832	91.9245
7451	金綱	カネツナ	61	7436	6290893	91.9254
7452	神定	カミサダ	61	7436	6290954	91.9263
7453	上条	カミジヨウ	61	7436	6291015	91.9271
7454	河原田	カワハラダ	61	7436	6291076	91.928
7455	菊入	キクイリ	61	7436	6291137	91.9289
7456	北橋	キタハシ	61	7436	6291198	91.9298
7457	帰山	キヤマ	61	7436	6291259	91.9307
7458	國田	クニタ	61	7436	6291320	91.9316
7459	結束	ケツソク	61	7436	6291381	91.9325
7460	小梶	コカジ	61	7436	6291442	91.9334
7461	古田土	コダト	61	7436	6291503	91.9343
7462	古寺	コデラ	61	7436	6291564	91.9352
7463	湖東	コトウ	61	7436	6291625	91.9361
7464	小屋敷	コヤシキ	61	7436	6291686	91.937
7465	紺谷	コンヤ	61	7436	6291747	91.9378
7466	讃岐	サヌキ	61	7436	6291808	91.9387
7467	沢畑	サワハタ	61	7436	6291869	91.9396
7468	蒋	シヨウ	61	7436	6291930	91.9405
7469	新沢	シンザワ	61	7436	6291991	91.9414
7470	杉谷	スギヤ	61	7436	6292052	91.9423
7471	砂押	スナオシ	61	7436	6292113	91.9432
7472	簾内	スノウチ	61	7436	6292174	91.9441
7473	■沢	タカサワ	61	7436	6292235	91.945
7474	高須賀	タカスカ	61	7436	6292296	91.9459
7475	田河	タガワ	61	7436	6292357	91.9468
7476	竹俣	タケマタ	61	7436	6292418	91.9476
7477	谷上	タニガミ	61	7436	6292479	91.9485
7478	垂石	タルイシ	61	7436	6292540	91.9494
7479	段	ダン	61	7436	6292601	91.9503
7480	近澤	チカザワ	61	7436	6292662	91.9512
7481	塚脇	ツカワキ	61	7436	6292723	91.9521
7482	津坂	ツサカ	61	7436	6292784	91.953
7483	手川	テガワ	61	7436	6292845	91.9539
7484	天明	テンメイ	61	7436	6292906	91.9548
7485	時津	トキツ	61	7436	6292967	91.9557
7486	冨澤	トミサワ	61	7436	6293028	91.9566
7487	富原	トミハラ	61	7436	6293089	91.9575
7488	中出	ナカイデ	61	7436	6293150	91.9583
7489	中河原	ナカガワラ	61	7436	6293211	91.9592
7490	中牟田	ナカムタ	61	7436	6293272	91.9601
7491	贄田	ニエダ	61	7436	6293333	91.961
7492	仁尾	ニオ	61	7436	6293394	91.9619
7493	二本松	ニホンマツ	61	7436	6293455	91.9628
7494	野方	ノガタ	61	7436	6293516	91.9637
7495	蓮本	ハスモト	61	7436	6293577	91.9646
7496	浜井	ハマイ	61	7436	6293638	91.9655
7497	匹田	ヒキタ	61	7436	6293699	91.9664
7498	平光	ヒラミツ	61	7436	6293760	91.9673
7499	吹越	フキコシ	61	7436	6293821	91.9681
7500	舟生	フニユウ	61	7436	6293882	91.969
7501	外薗	ホカゾノ	61	7436	6293943	91.9699
7502	保阪	ホサカ	61	7436	6294004	91.9708
7503	堀中	ホリナカ	61	7436	6294065	91.9717
7504	真板	マイタ	61	7436	6294126	91.9726
7505	前林	マエバヤシ	61	7436	6294187	91.9735
7506	政井	マサイ	61	7436	6294248	91.9744
7507	松添	マツゾエ	61	7436	6294309	91.9753
7508	円山	マルヤマ	61	7436	6294370	91.9762
7509	道田	ミチダ	61	7436	6294431	91.9771
7510	皆本	ミナモト	61	7436	6294492	91.978
7511	宮松	ミヤマツ	61	7436	6294553	91.9788
7512	村西	ムラニシ	61	7436	6294614	91.9797
7513	本■	モトヨシ	61	7436	6294675	91.9806
7514	八塚	ヤツヅカ	61	7436	6294736	91.9815
7515	柳内	ヤナイ	61	7436	6294797	91.9824
7516	雪田	ユキタ	61	7436	6294858	91.9833
7517	和井田	ワイダ	61	7436	6294919	91.9842
7518	姉帯	アネタイ	60	7518	6294979	91.9851
7519	伊佐治	イサジ	60	7518	6295039	91.9859
7520	石室	イシムロ	60	7518	6295099	91.9868
7521	市島	イチジマ	60	7518	6295159	91.9877
7522	伊良波	イラハ	60	7518	6295219	91.9886
7523	鵜川	ウガワ	60	7518	6295279	91.9895
7524	牛村	ウシムラ	60	7518	6295339	91.9903
7525	牛渡	ウシワタ	60	7518	6295399	91.9912
7526	宇津野	ウツノ	60	7518	6295459	91.9921
7527	産形	ウブカタ	60	7518	6295519	91.993
7528	大寺	オオデラ	60	7518	6295579	91.9938
7529	小河原	オガハラ	60	7518	6295639	91.9947
7530	忍田	オシダ	60	7518	6295699	91.9956
7531	小保内	オボナイ	60	7518	6295759	91.9965
7532	折尾	オリオ	60	7518	6295819	91.9973
7533	折口	オリグチ	60	7518	6295879	91.9982
7534	角舘	カクダテ	60	7518	6295939	91.9991
7535	忰田	カセダ	60	7518	6295999	92.0
7536	兼田	カネタ	60	7518	6296059	92.0009
7537	神坂	カミサカ	60	7518	6296119	92.0017
7538	鴨野	カモノ	60	7518	6296179	92.0026
7539	川	カワ	60	7518	6296239	92.0035
7540	川橋	カワハシ	60	7518	6296299	92.0044
7541	我如古	ガネコ	60	7518	6296359	92.0052
7542	木越	キゴシ	60	7518	6296419	92.0061
7543	喜瀬	キセ	60	7518	6296479	92.007
7544	吉瀬	キチセ	60	7518	6296539	92.0079
7545	鬼原	キハラ	60	7518	6296599	92.0087
7546	木森	キモリ	60	7518	6296659	92.0096
7547	草地	クサチ	60	7518	6296719	92.0105
7548	國枝	クニエダ	60	7518	6296779	92.0114
7549	國武	クニタケ	60	7518	6296839	92.0122
7550	蔵	クラ	60	7518	6296899	92.0131
7551	煙山	ケムリヤマ	60	7518	6296959	92.014
7552	顧	コ	60	7518	6297019	92.0149
7553	小荒井	コアライ	60	7518	6297079	92.0158
7554	小路	コウジ	60	7518	6297139	92.0166
7555	小芝	コシバ	60	7518	6297199	92.0175
7556	駒津	コマツ	60	7518	6297259	92.0184
7557	古渡	コワタリ	60	7518	6297319	92.0193
7558	五本木	ゴホンギ	60	7518	6297379	92.0201
7559	猿山	サルヤマ	60	7518	6297439	92.021
7560	■間	ザマ	60	7518	6297499	92.0219
7561	塩塚	シオツカ	60	7518	6297559	92.0228
7562	鹿倉	シカクラ	60	7518	6297619	92.0236
7563	下江	シモエ	60	7518	6297679	92.0245
7564	春藤	シユンドウ	60	7518	6297739	92.0254
7565	新野	シンノ	60	7518	6297799	92.0263
7566	煤賀	ススガ	60	7518	6297859	92.0272
7567	住岡	スミオカ	60	7518	6297919	92.028
7568	仙洞田	センドウダ	60	7518	6297979	92.0289
7569	田井中	タイナカ	60	7518	6298039	92.0298
7570	高■	タカサキ	60	7518	6298099	92.0307
7571	■萩	タカハギ	60	7518	6298159	92.0315
7572	田極	タゴク	60	7518	6298219	92.0324
7573	立山	タチヤマ	60	7518	6298279	92.0333
7574	田波	タナミ	60	7518	6298339	92.0342
7575	月田	ツキダ	60	7518	6298399	92.035
7576	常川	ツネカワ	60	7518	6298459	92.0359
7577	鶴山	ツルヤマ	60	7518	6298519	92.0368
7578	徳橋	トクハシ	60	7518	6298579	92.0377
7579	外丸	トマル	60	7518	6298639	92.0386
7580	富澤	トミサワ	60	7518	6298699	92.0394
7581	豊倉	トヨクラ	60	7518	6298759	92.0403
7582	中坂	ナカサカ	60	7518	6298819	92.0412
7583	仲座	ナカザ	60	7518	6298879	92.0421
7584	中条	ナカジヨウ	60	7518	6298939	92.0429
7585	永利	ナガトシ	60	7518	6298999	92.0438
7586	西根	ニシネ	60	7518	6299059	92.0447
7587	野頭	ノズ	60	7518	6299119	92.0456
7588	信沢	ノブサワ	60	7518	6299179	92.0464
7589	畑沢	ハタザワ	60	7518	6299239	92.0473
7590	秦野	ハダノ	60	7518	6299299	92.0482
7591	榛澤	ハンザワ	60	7518	6299359	92.0491
7592	引野	ヒキノ	60	7518	6299419	92.05
7593	肥沼	ヒヌマ	60	7518	6299479	92.0508
7594	開	ヒラキ	60	7518	6299539	92.0517
7595	広原	ヒロハラ	60	7518	6299599	92.0526
7596	古城	フルキ	60	7518	6299659	92.0535
7597	細水	ホソミズ	60	7518	6299719	92.0543
7598	松堂	マツドウ	60	7518	6299779	92.0552
7599	三ケ尻	ミカジリ	60	7518	6299839	92.0561
7600	三倉	ミクラ	60	7518	6299899	92.057
7601	見原	ミハラ	60	7518	6299959	92.0578
7602	物井	モノイ	60	7518	6300019	92.0587
7603	守泉	モリイズミ	60	7518	6300079	92.0596
7604	盛岡	モリオカ	60	7518	6300139	92.0605
7605	矢尾	ヤオ	60	7518	6300199	92.0613
7606	安福	ヤスフク	60	7518	6300259	92.0622
7607	■	ヤナギ	60	7518	6300319	92.0631
7608	雪下	ユキシタ	60	7518	6300379	92.064
7609	油谷	ユタニ	60	7518	6300439	92.0649
7610	由田	ヨシダ	60	7518	6300499	92.0657
7611	吉次	ヨシツグ	60	7518	6300559	92.0666
7612	類家	ルイケ	60	7518	6300619	92.0675
7613	脇野	ワキノ	60	7518	6300679	92.0684
7614	相木	アイキ	59	7614	6300738	92.0692
7615	安慶名	アゲナ	59	7614	6300797	92.0701
7616	阿南	アナミ	59	7614	6300856	92.0709
7617	有富	アリトミ	59	7614	6300915	92.0718
7618	伊吾田	イゴタ	59	7614	6300974	92.0727
7619	諌山	イサヤマ	59	7614	6301033	92.0735
7620	井端	イバタ	59	7614	6301092	92.0744
7621	上沢	ウエサワ	59	7614	6301151	92.0753
7622	牛窪	ウシクボ	59	7614	6301210	92.0761
7623	浦沢	ウラサワ	59	7614	6301269	92.077
7624	江塚	エヅカ	59	7614	6301328	92.0778
7625	荏原	エハラ	59	7614	6301387	92.0787
7626	袁	エン	59	7614	6301446	92.0796
7627	逢坂	オウサカ	59	7614	6301505	92.0804
7628	大掛	オオガケ	59	7614	6301564	92.0813
7629	大関	オオセキ	59	7614	6301623	92.0822
7630	小坂	オサカ	59	7614	6301682	92.083
7631	樫野	カシノ	59	7614	6301741	92.0839
7632	上遠野	カトオノ	59	7614	6301800	92.0847
7633	上地	カミチ	59	7614	6301859	92.0856
7634	川嶌	カワシマ	59	7614	6301918	92.0865
7635	木之下	キノシタ	59	7614	6301977	92.0873
7636	君嶋	キミジマ	59	7614	6302036	92.0882
7637	久徳	キユウトク	59	7614	6302095	92.0891
7638	國友	クニトモ	59	7614	6302154	92.0899
7639	熊王	クマオウ	59	7614	6302213	92.0908
7640	久村	クムラ	59	7614	6302272	92.0916
7641	黒谷	クロタニ	59	7614	6302331	92.0925
7642	古池	コイケ	59	7614	6302390	92.0934
7643	古宇田	コウダ	59	7614	6302449	92.0942
7644	小棚木	コタナギ	59	7614	6302508	92.0951
7645	寿	コトブキ	59	7614	6302567	92.096
7646	小針	コハリ	59	7614	6302626	92.0968
7647	紫藤	シドウ	59	7614	6302685	92.0977
7648	柴沼	シバヌマ	59	7614	6302744	92.0985
7649	地曳	ジビキ	59	7614	6302803	92.0994
7650	澄田	スミダ	59	7614	6302862	92.1003
7651	住■	スミヨシ	59	7614	6302921	92.1011
7652	清和	セイワ	59	7614	6302980	92.102
7653	瀬端	セバタ	59	7614	6303039	92.1028
7654	高川	タカガワ	59	7614	6303098	92.1037
7655	■草木	タカクサキ	59	7614	6303157	92.1046
7656	武末	タケスエ	59	7614	6303216	92.1054
7657	竹平	タケヒラ	59	7614	6303275	92.1063
7658	谷下	タニシタ	59	7614	6303334	92.1072
7659	樽木	タルキ	59	7614	6303393	92.108
7660	大道	ダイドウ	59	7614	6303452	92.1089
7661	築野	ツクノ	59	7614	6303511	92.1097
7662	津原	ツハラ	59	7614	6303570	92.1106
7663	傳田	デンダ	59	7614	6303629	92.1115
7664	東条	トウジヨウ	59	7614	6303688	92.1123
7665	徳弘	トクヒロ	59	7614	6303747	92.1132
7666	栃本	トチモト	59	7614	6303806	92.1141
7667	飛山	トビヤマ	59	7614	6303865	92.1149
7668	富田	トミダ	59	7614	6303924	92.1158
7669	豊住	トヨズミ	59	7614	6303983	92.1166
7670	長洲	ナガス	59	7614	6304042	92.1175
7671	名越	ナコシ	59	7614	6304101	92.1184
7672	夏堀	ナツボリ	59	7614	6304160	92.1192
7673	西丸	ニシマル	59	7614	6304219	92.1201
7674	入戸野	ニツトノ	59	7614	6304278	92.121
7675	根井	ネイ	59	7614	6304337	92.1218
7676	能村	ノムラ	59	7614	6304396	92.1227
7677	羽下	ハガ	59	7614	6304455	92.1235
7678	初瀬	ハツセ	59	7614	6304514	92.1244
7679	氷室	ヒムロ	59	7614	6304573	92.1253
7680	古荘	フルシヨウ	59	7614	6304632	92.1261
7681	保泉	ホイズミ	59	7614	6304691	92.127
7682	北郷	ホンゴウ	59	7614	6304750	92.1278
7683	萬田	マンダ	59	7614	6304809	92.1287
7684	道又	ミチマタ	59	7614	6304868	92.1296
7685	三岡	ミツオカ	59	7614	6304927	92.1304
7686	三友	ミトモ	59	7614	6304986	92.1313
7687	三間	ミマ	59	7614	6305045	92.1322
7688	宮上	ミヤガミ	59	7614	6305104	92.133
7689	邑上	ムラカミ	59	7614	6305163	92.1339
7690	門司	モンジ	59	7614	6305222	92.1347
7691	安澤	ヤスザワ	59	7614	6305281	92.1356
7692	安諸	ヤスモロ	59	7614	6305340	92.1365
7693	■原	ヤナギハラ	59	7614	6305399	92.1373
7694	弓場	ユミバ	59	7614	6305458	92.1382
7695	■■	ヨシザキ	59	7614	6305517	92.1391
7696	脇元	ワキモト	59	7614	6305576	92.1399
7697	湧井	ワクイ	59	7614	6305635	92.1408
7698	相庭	アイバ	58	7698	6305693	92.1416
7699	相山	アイヤマ	58	7698	6305751	92.1425
7700	赤木	アカキ	58	7698	6305809	92.1433
7701	赤倉	アカクラ	58	7698	6305867	92.1442
7702	秋好	アキヨシ	58	7698	6305925	92.145
7703	阿由葉	アユハ	58	7698	6305983	92.1459
7704	石鍋	イシナベ	58	7698	6306041	92.1467
7705	磯島	イソジマ	58	7698	6306099	92.1476
7706	今松	イママツ	58	7698	6306157	92.1484
7707	江角	エスミ	58	7698	6306215	92.1493
7708	王	オ−	58	7698	6306273	92.1501
7709	小曽根	オゾネ	58	7698	6306331	92.151
7710	尾谷	オタニ	58	7698	6306389	92.1518
7711	小竹	オダケ	58	7698	6306447	92.1526
7712	尾鷲	オワシ	58	7698	6306505	92.1535
7713	数田	カズタ	58	7698	6306563	92.1543
7714	勝股	カツマタ	58	7698	6306621	92.1552
7715	金原	カナハラ	58	7698	6306679	92.156
7716	河地	カワチ	58	7698	6306737	92.1569
7717	川股	カワマタ	58	7698	6306795	92.1577
7718	川森	カワモリ	58	7698	6306853	92.1586
7719	北舘	キタダテ	58	7698	6306911	92.1594
7720	木屋	キヤ	58	7698	6306969	92.1603
7721	葛巻	クズマキ	58	7698	6307027	92.1611
7722	熊耳	クマガミ	58	7698	6307085	92.162
7723	黒尾	クロオ	58	7698	6307143	92.1628
7724	小雀	コスズメ	58	7698	6307201	92.1637
7725	米須	コメス	58	7698	6307259	92.1645
7726	佐々井	ササイ	58	7698	6307317	92.1654
7727	佐塚	サヅカ	58	7698	6307375	92.1662
7728	山藤	サンドウ	58	7698	6307433	92.1671
7729	芝宮	シバミヤ	58	7698	6307491	92.1679
7730	島宗	シマムネ	58	7698	6307549	92.1687
7731	下浦	シモウラ	58	7698	6307607	92.1696
7732	菖蒲	シヨウブ	58	7698	6307665	92.1704
7733	白土	シラド	58	7698	6307723	92.1713
7734	新森	シンモリ	58	7698	6307781	92.1721
7735	末川	スエカワ	58	7698	6307839	92.173
7736	曽雌	ソシ	58	7698	6307897	92.1738
7737	高草木	タカクサギ	58	7698	6307955	92.1747
7738	高鳥	タカトリ	58	7698	6308013	92.1755
7739	■見沢	タカミザワ	58	7698	6308071	92.1764
7740	谷越	タニコシ	58	7698	6308129	92.1772
7741	釣	ツリ	58	7698	6308187	92.1781
7742	田頭	デンドウ	58	7698	6308245	92.1789
7743	友山	トモヤマ	58	7698	6308303	92.1798
7744	長久	ナガヒサ	58	7698	6308361	92.1806
7745	夏山	ナツヤマ	58	7698	6308419	92.1815
7746	並川	ナミカワ	58	7698	6308477	92.1823
7747	奈良部	ナラベ	58	7698	6308535	92.1832
7748	根津	ネツ	58	7698	6308593	92.184
7749	信岡	ノブオカ	58	7698	6308651	92.1849
7750	橋間	ハシマ	58	7698	6308709	92.1857
7751	平向	ヒラムキ	58	7698	6308767	92.1865
7752	降幡	フリハタ	58	7698	6308825	92.1874
7753	保田	ホダ	58	7698	6308883	92.1882
7754	牧岡	マキオカ	58	7698	6308941	92.1891
7755	間渕	マブチ	58	7698	6308999	92.1899
7756	馬淵	マブチ	58	7698	6309057	92.1908
7757	溝越	ミゾコシ	58	7698	6309115	92.1916
7758	満田	ミツタ	58	7698	6309173	92.1925
7759	三繩	ミナワ	58	7698	6309231	92.1933
7760	峰田	ミネタ	58	7698	6309289	92.1942
7761	村椿	ムラツバキ	58	7698	6309347	92.195
7762	森西	モリニシ	58	7698	6309405	92.1959
7763	森光	モリミツ	58	7698	6309463	92.1967
7764	諸富	モロトミ	58	7698	6309521	92.1976
7765	門田	モンダ	58	7698	6309579	92.1984
7766	谷野	ヤトノ	58	7698	6309637	92.1993
7767	柳谷	ヤナギタニ	58	7698	6309695	92.2001
7768	米須	ヨネス	58	7698	6309753	92.201
7769	六川	ロクカワ	58	7698	6309811	92.2018
7770	渡壁	ワタカベ	58	7698	6309869	92.2027
7771	有島	アリシマ	57	7771	6309926	92.2035
7772	飯坂	イイサカ	57	7771	6309983	92.2043
7773	石合	イシアイ	57	7771	6310040	92.2051
7774	石出	イシデ	57	7771	6310097	92.206
7775	石幡	イシハタ	57	7771	6310154	92.2068
7776	岩重	イワシゲ	57	7771	6310211	92.2076
7777	岩科	イワシナ	57	7771	6310268	92.2085
7778	梅垣	ウメガキ	57	7771	6310325	92.2093
7779	大内田	オオウチダ	57	7771	6310382	92.2101
7780	大図	オオズ	57	7771	6310439	92.211
7781	大瀬良	オオセラ	57	7771	6310496	92.2118
7782	大保	オオボ	57	7771	6310553	92.2126
7783	尾木	オギ	57	7771	6310610	92.2135
7784	柿添	カキゾエ	57	7771	6310667	92.2143
7785	金光	カナミツ	57	7771	6310724	92.2151
7786	鬼海	キカイ	57	7771	6310781	92.216
7787	木上	キガミ	57	7771	6310838	92.2168
7788	北浜	キタハマ	57	7771	6310895	92.2176
7789	喜村	キムラ	57	7771	6310952	92.2185
7790	窪園	クボゾノ	57	7771	6311009	92.2193
7791	古性	コシヨウ	57	7771	6311066	92.2201
7792	佐草	サソウ	57	7771	6311123	92.221
7793	佐東	サトウ	57	7771	6311180	92.2218
7794	重成	シゲナリ	57	7771	6311237	92.2226
7795	雫	シズク	57	7771	6311294	92.2235
7796	志藤	シドウ	57	7771	6311351	92.2243
7797	島影	シマカゲ	57	7771	6311408	92.2251
7798	嶋中	シマナカ	57	7771	6311465	92.226
7799	辛	シン	57	7771	6311522	92.2268
7800	新田	シンデン	57	7771	6311579	92.2276
7801	新屋敷	シンヤシキ	57	7771	6311636	92.2285
7802	杉戸	スギト	57	7771	6311693	92.2293
7803	住川	スミカワ	57	7771	6311750	92.2301
7804	瀬之間	セノマ	57	7771	6311807	92.231
7805	対間	タイマ	57	7771	6311864	92.2318
7806	■濱	タカハマ	57	7771	6311921	92.2326
7807	高屋敷	タカヤシキ	57	7771	6311978	92.2335
7808	武重	タケシゲ	57	7771	6312035	92.2343
7809	立岡	タツオカ	57	7771	6312092	92.2351
7810	辻山	ツジヤマ	57	7771	6312149	92.236
7811	都竹	ツヅク	57	7771	6312206	92.2368
7812	寺野	テラノ	57	7771	6312263	92.2376
7813	東間	トウマ	57	7771	6312320	92.2385
7814	冨野	トミノ	57	7771	6312377	92.2393
7815	朝永	トモナガ	57	7771	6312434	92.2401
7816	中新井	ナカアライ	57	7771	6312491	92.241
7817	永末	ナガスエ	57	7771	6312548	92.2418
7818	那知	ナチ	57	7771	6312605	92.2426
7819	夏見	ナツミ	57	7771	6312662	92.2435
7820	浪花	ナニワ	57	7771	6312719	92.2443
7821	波平	ナミヒラ	57	7771	6312776	92.2451
7822	成岡	ナリオカ	57	7771	6312833	92.246
7823	南保	ナンポ	57	7771	6312890	92.2468
7824	新納	ニイノ	57	7771	6312947	92.2476
7825	西潟	ニシカタ	57	7771	6313004	92.2485
7826	西永	ニシナガ	57	7771	6313061	92.2493
7827	野秋	ノアキ	57	7771	6313118	92.2501
7828	箱山	ハコヤマ	57	7771	6313175	92.251
7829	畠野	ハタノ	57	7771	6313232	92.2518
7830	埴原	ハニハラ	57	7771	6313289	92.2526
7831	浜脇	ハマワキ	57	7771	6313346	92.2535
7832	日根	ヒネ	57	7771	6313403	92.2543
7833	黄	フアン	57	7771	6313460	92.2551
7834	二木	フタギ	57	7771	6313517	92.256
7835	舟津	フナツ	57	7771	6313574	92.2568
7836	細内	ホソウチ	57	7771	6313631	92.2576
7837	細沢	ホソザワ	57	7771	6313688	92.2585
7838	前坂	マエサカ	57	7771	6313745	92.2593
7839	蒔苗	マカナエ	57	7771	6313802	92.2601
7840	馬島	マジマ	57	7771	6313859	92.261
7841	舛谷	マスヤ	57	7771	6313916	92.2618
7842	間藤	マトウ	57	7771	6313973	92.2626
7843	南方	ミナカタ	57	7771	6314030	92.2635
7844	峯島	ミネシマ	57	7771	6314087	92.2643
7845	室本	ムロモト	57	7771	6314144	92.2651
7846	元川	モトカワ	57	7771	6314201	92.266
7847	諸泉	モロイズミ	57	7771	6314258	92.2668
7848	矢崎	ヤサキ	57	7771	6314315	92.2676
7849	谷内	ヤナイ	57	7771	6314372	92.2685
7850	山入端	ヤマノハ	57	7771	6314429	92.2693
7851	横濱	ヨコハマ	57	7771	6314486	92.2701
7852	與那嶺	ヨナミネ	57	7771	6314543	92.2709
7853	米屋	ヨネヤ	57	7771	6314600	92.2718
7854	和久田	ワクダ	57	7771	6314657	92.2726
7855	輪湖	ワコ	57	7771	6314714	92.2734
7856	鷲津	ワシヅ	57	7771	6314771	92.2743
7857	愛沢	アイザワ	56	7857	6314827	92.2751
7858	相島	アイジマ	56	7857	6314883	92.2759
7859	渥見	アツミ	56	7857	6314939	92.2767
7860	安積	アヅミ	56	7857	6314995	92.2776
7861	天池	アマイケ	56	7857	6315051	92.2784
7862	家本	イエモト	56	7857	6315107	92.2792
7863	生山	イクヤマ	56	7857	6315163	92.28
7864	池嶋	イケジマ	56	7857	6315219	92.2808
7865	池羽	イケバ	56	7857	6315275	92.2816
7866	磯江	イソエ	56	7857	6315331	92.2825
7867	一ノ宮	イチノミヤ	56	7857	6315387	92.2833
7868	出原	イデハラ	56	7857	6315443	92.2841
7869	稲橋	イナハシ	56	7857	6315499	92.2849
7870	井場	イバ	56	7857	6315555	92.2857
7871	今沢	イマザワ	56	7857	6315611	92.2866
7872	井料	イリヨウ	56	7857	6315667	92.2874
7873	岩清水	イワシミズ	56	7857	6315723	92.2882
7874	内園	ウチゾノ	56	7857	6315779	92.289
7875	運天	ウンテン	56	7857	6315835	92.2898
7876	永川	エイカワ	56	7857	6315891	92.2906
7877	江平	エヒラ	56	7857	6315947	92.2915
7878	呉	オ	56	7857	6316003	92.2923
7879	小谷	オタニ	56	7857	6316059	92.2931
7880	貝原	カイバラ	56	7857	6316115	92.2939
7881	嘉瀬	カセ	56	7857	6316171	92.2947
7882	加福	カフク	56	7857	6316227	92.2956
7883	神倉	カミクラ	56	7857	6316283	92.2964
7884	神園	カミゾノ	56	7857	6316339	92.2972
7885	茅原	カヤハラ	56	7857	6316395	92.298
7886	紀	キノ	56	7857	6316451	92.2988
7887	国方	クニカタ	56	7857	6316507	92.2996
7888	国谷	クニヤ	56	7857	6316563	92.3005
7889	研修	ケンシユウ	56	7857	6316619	92.3013
7890	小笹	コササ	56	7857	6316675	92.3021
7891	五味田	ゴミタ	56	7857	6316731	92.3029
7892	斉賀	サイガ	56	7857	6316787	92.3037
7893	榊原	サカキハラ	56	7857	6316843	92.3046
7894	酒谷	サカタニ	56	7857	6316899	92.3054
7895	山東	サントウ	56	7857	6316955	92.3062
7896	三瓶	サンベ	56	7857	6317011	92.307
7897	塩坂	シオサカ	56	7857	6317067	92.3078
7898	下谷	シモタニ	56	7857	6317123	92.3086
7899	周藤	シユウドウ	56	7857	6317179	92.3095
7900	白橋	シラハシ	56	7857	6317235	92.3103
7901	洲鎌	スガマ	56	7857	6317291	92.3111
7902	角屋	スミヤ	56	7857	6317347	92.3119
7903	住山	スミヤマ	56	7857	6317403	92.3127
7904	銭谷	ゼニヤ	56	7857	6317459	92.3136
7905	高藤	タカトウ	56	7857	6317515	92.3144
7906	高場	タカバ	56	7857	6317571	92.3152
7907	田津原	タツハラ	56	7857	6317627	92.316
7908	坪松	ツボマツ	56	7857	6317683	92.3168
7909	戸崎	トサキ	56	7857	6317739	92.3177
7910	冨塚	トミツカ	56	7857	6317795	92.3185
7911	豊浦	トヨウラ	56	7857	6317851	92.3193
7912	中濱	ナカハマ	56	7857	6317907	92.3201
7913	永浜	ナガハマ	56	7857	6317963	92.3209
7914	夏川	ナツカワ	56	7857	6318019	92.3217
7915	奈良崎	ナラザキ	56	7857	6318075	92.3226
7916	仁井	ニイ	56	7857	6318131	92.3234
7917	西坂	ニシサカ	56	7857	6318187	92.3242
7918	西埜	ニシノ	56	7857	6318243	92.325
7919	能重	ノウジユウ	56	7857	6318299	92.3258
7920	野神	ノガミ	56	7857	6318355	92.3267
7921	野際	ノギワ	56	7857	6318411	92.3275
7922	能島	ノジマ	56	7857	6318467	92.3283
7923	野地	ノチ	56	7857	6318523	92.3291
7924	則武	ノリタケ	56	7857	6318579	92.3299
7925	野呂瀬	ノロセ	56	7857	6318635	92.3307
7926	羽沢	ハザワ	56	7857	6318691	92.3316
7927	橋上	ハシガミ	56	7857	6318747	92.3324
7928	橋詰	ハシズメ	56	7857	6318803	92.3332
7929	榛葉	ハシバ	56	7857	6318859	92.334
7930	橋谷田	ハシヤダ	56	7857	6318915	92.3348
7931	初鹿	ハツシカ	56	7857	6318971	92.3357
7932	花坂	ハナサカ	56	7857	6319027	92.3365
7933	春本	ハルモト	56	7857	6319083	92.3373
7934	広畑	ヒロハタ	56	7857	6319139	92.3381
7935	渕野	フチノ	56	7857	6319195	92.3389
7936	帆苅	ホカリ	56	7857	6319251	92.3397
7937	細岡	ホソオカ	56	7857	6319307	92.3406
7938	保谷	ホヤ	56	7857	6319363	92.3414
7939	前薗	マエゾノ	56	7857	6319419	92.3422
7940	槇島	マキシマ	56	7857	6319475	92.343
7941	松崎	マツサキ	56	7857	6319531	92.3438
7942	三笠	ミカサ	56	7857	6319587	92.3447
7943	三簾	ミスイ	56	7857	6319643	92.3455
7944	三ツ木	ミツキ	56	7857	6319699	92.3463
7945	三部	ミベ	56	7857	6319755	92.3471
7946	守岡	モリオカ	56	7857	6319811	92.3479
7947	諸隈	モロクマ	56	7857	6319867	92.3487
7948	梁井	ヤナイ	56	7857	6319923	92.3496
7949	山邊	ヤマベ	56	7857	6319979	92.3504
7950	和泉	ワイズミ	56	7857	6320035	92.3512
7951	鷲谷	ワシヤ	56	7857	6320091	92.352
7952	青塚	アオツカ	55	7952	6320146	92.3528
7953	安芸	アキ	55	7952	6320201	92.3536
7954	飛鳥	アスカ	55	7952	6320256	92.3544
7955	足助	アスケ	55	7952	6320311	92.3552
7956	雨谷	アマヤ	55	7952	6320366	92.356
7957	雨森	アメモリ	55	7952	6320421	92.3568
7958	伊久美	イクミ	55	7952	6320476	92.3576
7959	一川	イチカワ	55	7952	6320531	92.3584
7960	稲益	イナマス	55	7952	6320586	92.3593
7961	射場	イバ	55	7952	6320641	92.3601
7962	今藤	イマフジ	55	7952	6320696	92.3609
7963	岩垣	イワガキ	55	7952	6320751	92.3617
7964	岩出	イワデ	55	7952	6320806	92.3625
7965	黄木	オオキ	55	7952	6320861	92.3633
7966	大田原	オオタハラ	55	7952	6320916	92.3641
7967	大箭	オオヤ	55	7952	6320971	92.3649
7968	開田	カイダ	55	7952	6321026	92.3657
7969	開発	カイハツ	55	7952	6321081	92.3665
7970	影浦	カゲウラ	55	7952	6321136	92.3673
7971	椛澤	カバサワ	55	7952	6321191	92.3681
7972	加辺	カベ	55	7952	6321246	92.3689
7973	亀川	カメガワ	55	7952	6321301	92.3697
7974	鴨	カモ	55	7952	6321356	92.3705
7975	川城	カワシロ	55	7952	6321411	92.3713
7976	簡	カン	55	7952	6321466	92.3721
7977	木川田	キカワダ	55	7952	6321521	92.3729
7978	北森	キタモリ	55	7952	6321576	92.3737
7979	京谷	キヨウタニ	55	7952	6321631	92.3745
7980	清松	キヨマツ	55	7952	6321686	92.3753
7981	小礒	コイソ	55	7952	6321741	92.3761
7982	小崎	コサキ	55	7952	6321796	92.3769
7983	坂寄	サカヨリ	55	7952	6321851	92.3777
7984	左近	サコン	55	7952	6321906	92.3785
7985	澤地	サワチ	55	7952	6321961	92.3793
7986	澤柳	サワヤナギ	55	7952	6322016	92.3801
7987	塩本	シオモト	55	7952	6322071	92.381
7988	志鎌	シカマ	55	7952	6322126	92.3818
7989	七里	シチリ	55	7952	6322181	92.3826
7990	標	シメギ	55	7952	6322236	92.3834
7991	下屋敷	シモヤシキ	55	7952	6322291	92.3842
7992	城	シロ	55	7952	6322346	92.385
7993	新戸	シント	55	7952	6322401	92.3858
7994	末藤	スエフジ	55	7952	6322456	92.3866
7995	菅根	スガネ	55	7952	6322511	92.3874
7996	関場	セキバ	55	7952	6322566	92.3882
7997	瀬島	セジマ	55	7952	6322621	92.389
7998	瀬能	セノウ	55	7952	6322676	92.3898
7999	滝谷	タキヤ	55	7952	6322731	92.3906
8000	瀧山	タキヤマ	55	7952	6322786	92.3914
8001	俵谷	タワラヤ	55	7952	6322841	92.3922
8002	大坊	ダイボウ	55	7952	6322896	92.393
8003	東藤	トウドウ	55	7952	6322951	92.3938
8004	栂野	トガノ	55	7952	6323006	92.3946
8005	渡名喜	トナキ	55	7952	6323061	92.3954
8006	登内	トノウチ	55	7952	6323116	92.3962
8007	外崎	トノザキ	55	7952	6323171	92.397
8008	中久保	ナカクボ	55	7952	6323226	92.3978
8009	中越	ナカコシ	55	7952	6323281	92.3986
8010	仲道	ナカミチ	55	7952	6323336	92.3994
8011	夏梅	ナツウメ	55	7952	6323391	92.4002
8012	新納	ニイノウ	55	7952	6323446	92.401
8013	西薗	ニシゾノ	55	7952	6323501	92.4018
8014	西場	ニシバ	55	7952	6323556	92.4027
8015	野城	ノシロ	55	7952	6323611	92.4035
8016	橋谷	ハシタニ	55	7952	6323666	92.4043
8017	初田	ハツダ	55	7952	6323721	92.4051
8018	花家	ハナイエ	55	7952	6323776	92.4059
8019	羽成	ハナリ	55	7952	6323831	92.4067
8020	番	バン	55	7952	6323886	92.4075
8021	日浅	ヒアサ	55	7952	6323941	92.4083
8022	廣崎	ヒロサキ	55	7952	6323996	92.4091
8023	深松	フカマツ	55	7952	6324051	92.4099
8024	藤垣	フジガキ	55	7952	6324106	92.4107
8025	藤咲	フジサク	55	7952	6324161	92.4115
8026	古屋敷	フルヤシキ	55	7952	6324216	92.4123
8027	外尾	ホカオ	55	7952	6324271	92.4131
8028	堀崎	ホリサキ	55	7952	6324326	92.4139
8029	前井	マエイ	55	7952	6324381	92.4147
8030	政岡	マサオカ	55	7952	6324436	92.4155
8031	政所	マンドコロ	55	7952	6324491	92.4163
8032	三■	ミサキ	55	7952	6324546	92.4171
8033	水岡	ミズオカ	55	7952	6324601	92.4179
8034	三津木	ミツギ	55	7952	6324656	92.4187
8035	三辻	ミツジ	55	7952	6324711	92.4195
8036	宮城島	ミヤギシマ	55	7952	6324766	92.4203
8037	茂庭	モニワ	55	7952	6324821	92.4211
8038	諸墨	モロズミ	55	7952	6324876	92.4219
8039	■沢	ヤナギサワ	55	7952	6324931	92.4227
8040	籔田	ヤブタ	55	7952	6324986	92.4235
8041	米	ヨネ	55	7952	6325041	92.4244
8042	與安	ヨヤス	55	7952	6325096	92.4252
8043	若田部	ワカタベ	55	7952	6325151	92.426
8044	和嶋	ワジマ	55	7952	6325206	92.4268
8045	油谷	アブラタニ	54	8045	6325260	92.4276
8046	綾井	アヤイ	54	8045	6325314	92.4283
8047	荒沢	アラサワ	54	8045	6325368	92.4291
8048	荒澤	アラサワ	54	8045	6325422	92.4299
8049	井	イ	54	8045	6325476	92.4307
8050	壹岐	イキ	54	8045	6325530	92.4315
8051	礒■	イソザキ	54	8045	6325584	92.4323
8052	今城	イマシロ	54	8045	6325638	92.4331
8053	今屋	イマヤ	54	8045	6325692	92.4339
8054	伊■	イレイ	54	8045	6325746	92.4347
8055	岩井田	イワイダ	54	8045	6325800	92.4354
8056	岩満	イワミツ	54	8045	6325854	92.4362
8057	上平	ウエヒラ	54	8045	6325908	92.437
8058	魚谷	ウオタニ	54	8045	6325962	92.4378
8059	梅■	ウメザキ	54	8045	6326016	92.4386
8060	上井	ウワイ	54	8045	6326070	92.4394
8061	枝光	エダミツ	54	8045	6326124	92.4402
8062	太田代	オオタシロ	54	8045	6326178	92.441
8063	大水	オオミズ	54	8045	6326232	92.4418
8064	大南	オオミナミ	54	8045	6326286	92.4425
8065	奥田	オクタ	54	8045	6326340	92.4433
8066	小高	オタカ	54	8045	6326394	92.4441
8067	小内	オナイ	54	8045	6326448	92.4449
8068	鹿児島	カゴシマ	54	8045	6326502	92.4457
8069	笠川	カサガワ	54	8045	6326556	92.4465
8070	笠置	カサギ	54	8045	6326610	92.4473
8071	橿渕	カシブチ	54	8045	6326664	92.4481
8072	嘉成	カナリ	54	8045	6326718	92.4489
8073	叶内	カノウチ	54	8045	6326772	92.4496
8074	鹿目	カノメ	54	8045	6326826	92.4504
8075	鴨田	カモタ	54	8045	6326880	92.4512
8076	蒲地	カモチ	54	8045	6326934	92.452
8077	川道	カワミチ	54	8045	6326988	92.4528
8078	岸岡	キシオカ	54	8045	6327042	92.4536
8079	黒丸	クロマル	54	8045	6327096	92.4544
8080	康	コウ	54	8045	6327150	92.4552
8081	小沢	コザワ	54	8045	6327204	92.456
8082	小檜山	コビヤマ	54	8045	6327258	92.4567
8083	才田	サイダ	54	8045	6327312	92.4575
8084	沢崎	サワサキ	54	8045	6327366	92.4583
8085	澤藤	サワフジ	54	8045	6327420	92.4591
8086	三宮	サングウ	54	8045	6327474	92.4599
8087	柴谷	シバヤ	54	8045	6327528	92.4607
8088	下口	シモグチ	54	8045	6327582	92.4615
8089	白熊	シラクマ	54	8045	6327636	92.4623
8090	千秋	センシユウ	54	8045	6327690	92.4631
8091	對間	タイマ	54	8045	6327744	92.4638
8092	■浜	タカハマ	54	8045	6327798	92.4646
8093	鷹見	タカミ	54	8045	6327852	92.4654
8094	滝田	タキダ	54	8045	6327906	92.4662
8095	田原	タバラ	54	8045	6327960	92.467
8096	玉川	タマカワ	54	8045	6328014	92.4678
8097	田原	タワラ	54	8045	6328068	92.4686
8098	筑井	ツクイ	54	8045	6328122	92.4694
8099	鶴原	ツルハラ	54	8045	6328176	92.4702
8100	寺澤	テラザワ	54	8045	6328230	92.4709
8101	得田	トクダ	54	8045	6328284	92.4717
8102	利	トシ	54	8045	6328338	92.4725
8103	戸津	トツ	54	8045	6328392	92.4733
8104	富島	トミシマ	54	8045	6328446	92.4741
8105	鳴瀬	ナルセ	54	8045	6328500	92.4749
8106	錦織	ニシゴリ	54	8045	6328554	92.4757
8107	埜村	ノムラ	54	8045	6328608	92.4765
8108	朏島	ハイジマ	54	8045	6328662	92.4773
8109	畑谷	ハタヤ	54	8045	6328716	92.4781
8110	針ケ谷	ハリガヤ	54	8045	6328770	92.4788
8111	東浦	ヒガシウラ	54	8045	6328824	92.4796
8112	日詰	ヒヅメ	54	8045	6328878	92.4804
8113	深海	フカミ	54	8045	6328932	92.4812
8114	福満	フクミツ	54	8045	6328986	92.482
8115	藤咲	フジサキ	54	8045	6329040	92.4828
8116	船坂	フナサカ	54	8045	6329094	92.4836
8117	降矢	フリヤ	54	8045	6329148	92.4844
8118	星沢	ホシザワ	54	8045	6329202	92.4852
8119	保立	ホタテ	54	8045	6329256	92.4859
8120	本村	ホンムラ	54	8045	6329310	92.4867
8121	松場	マツバ	54	8045	6329364	92.4875
8122	萬代	マンダイ	54	8045	6329418	92.4883
8123	室園	ムロゾノ	54	8045	6329472	92.4891
8124	室山	ムロヤマ	54	8045	6329526	92.4899
8125	門前	モンゼン	54	8045	6329580	92.4907
8126	吉屋	ヨシヤ	54	8045	6329634	92.4915
8127	領家	リヨウケ	54	8045	6329688	92.4923
8128	若村	ワカムラ	54	8045	6329742	92.493
8129	味戸	アジト	53	8129	6329795	92.4938
8130	安嶋	アジマ	53	8129	6329848	92.4946
8131	小豆畑	アズハタ	53	8129	6329901	92.4954
8132	網谷	アミタニ	53	8129	6329954	92.4961
8133	有藤	アリトウ	53	8129	6330007	92.4969
8134	粟井	アワイ	53	8129	6330060	92.4977
8135	伊勢崎	イセザキ	53	8129	6330113	92.4985
8136	井戸田	イトダ	53	8129	6330166	92.4992
8137	稲塚	イナヅカ	53	8129	6330219	92.5
8138	浮須	ウキス	53	8129	6330272	92.5008
8139	笛吹	ウスイ	53	8129	6330325	92.5016
8140	梅井	ウメイ	53	8129	6330378	92.5023
8141	梅田	ウメタ	53	8129	6330431	92.5031
8142	楳田	ウメダ	53	8129	6330484	92.5039
8143	黄木	オウキ	53	8129	6330537	92.5047
8144	大口	オオクチ	53	8129	6330590	92.5054
8145	大年	オオトシ	53	8129	6330643	92.5062
8146	桶田	オケダ	53	8129	6330696	92.507
8147	尾登	オト	53	8129	6330749	92.5078
8148	小野川	オノガワ	53	8129	6330802	92.5085
8149	開米	カイマイ	53	8129	6330855	92.5093
8150	蛎崎	カキザキ	53	8129	6330908	92.5101
8151	垣田	カキタ	53	8129	6330961	92.5109
8152	角本	カクモト	53	8129	6331014	92.5116
8153	釜井	カマイ	53	8129	6331067	92.5124
8154	上浦	カミウラ	53	8129	6331120	92.5132
8155	上妻	カミツマ	53	8129	6331173	92.514
8156	川幡	カワハタ	53	8129	6331226	92.5147
8157	河原	カワラ	53	8129	6331279	92.5155
8158	川脇	カワワキ	53	8129	6331332	92.5163
8159	北堀	キタホリ	53	8129	6331385	92.5171
8160	京田	キヨウダ	53	8129	6331438	92.5178
8161	櫛部	クシベ	53	8129	6331491	92.5186
8162	功力	クヌギ	53	8129	6331544	92.5194
8163	熊丸	クママル	53	8129	6331597	92.5201
8164	栗須	クリス	53	8129	6331650	92.5209
8165	久留島	クルシマ	53	8129	6331703	92.5217
8166	黒羽根	クロバネ	53	8129	6331756	92.5225
8167	■持	ケンモツ	53	8129	6331809	92.5232
8168	小泉	コイヅミ	53	8129	6331862	92.524
8169	幸保	コウボ	53	8129	6331915	92.5248
8170	甲山	コウヤマ	53	8129	6331968	92.5256
8171	小■	コザキ	53	8129	6332021	92.5263
8172	駒谷	コマヤ	53	8129	6332074	92.5271
8173	佐浦	サウラ	53	8129	6332127	92.5279
8174	坂原	サカハラ	53	8129	6332180	92.5287
8175	鷺谷	サギヤ	53	8129	6332233	92.5294
8176	薩摩	サツマ	53	8129	6332286	92.5302
8177	志和	シワ	53	8129	6332339	92.531
8178	薄田	ススキダ	53	8129	6332392	92.5318
8179	砂賀	スナガ	53	8129	6332445	92.5325
8180	瀬賀	セガ	53	8129	6332498	92.5333
8181	瀬野尾	セノオ	53	8129	6332551	92.5341
8182	仙場	センバ	53	8129	6332604	92.5349
8183	鷹箸	タカノハシ	53	8129	6332657	92.5356
8184	詫間	タクマ	53	8129	6332710	92.5364
8185	舘内	タテウチ	53	8129	6332763	92.5372
8186	大藤	ダイトウ	53	8129	6332816	92.538
8187	常泉	ツネイズミ	53	8129	6332869	92.5387
8188	刀祢	トネ	53	8129	6332922	92.5395
8189	戸祭	トマツリ	53	8129	6332975	92.5403
8190	仲嶋	ナカジマ	53	8129	6333028	92.5411
8191	仲摩	ナカマ	53	8129	6333081	92.5418
8192	永長	ナガオサ	53	8129	6333134	92.5426
8193	七島	ナナシマ	53	8129	6333187	92.5434
8194	縄島	ナワシマ	53	8129	6333240	92.5442
8195	畑下	ハタシタ	53	8129	6333293	92.5449
8196	畑本	ハタモト	53	8129	6333346	92.5457
8197	花塚	ハナツカ	53	8129	6333399	92.5465
8198	羽布津	ハブツ	53	8129	6333452	92.5473
8199	原科	ハラシナ	53	8129	6333505	92.548
8200	潘	ハン	53	8129	6333558	92.5488
8201	東恩納	ヒガシオンナ	53	8129	6333611	92.5496
8202	東本	ヒガシモト	53	8129	6333664	92.5504
8203	曰比谷	ヒビヤ	53	8129	6333717	92.5511
8204	広津	ヒロツ	53	8129	6333770	92.5519
8205	渕田	フチダ	53	8129	6333823	92.5527
8206	船生	フニユウ	53	8129	6333876	92.5535
8207	保木	ホキ	53	8129	6333929	92.5542
8208	保倉	ホクラ	53	8129	6333982	92.555
8209	堀ノ内	ホリノウチ	53	8129	6334035	92.5558
8210	待井	マチイ	53	8129	6334088	92.5565
8211	松方	マツカタ	53	8129	6334141	92.5573
8212	松舘	マツダテ	53	8129	6334194	92.5581
8213	三保谷	ミホヤ	53	8129	6334247	92.5589
8214	宮国	ミヤクニ	53	8129	6334300	92.5596
8215	椋木	ムクノキ	53	8129	6334353	92.5604
8216	村里	ムラサト	53	8129	6334406	92.5612
8217	本谷	モトタニ	53	8129	6334459	92.562
8218	元松	モトマツ	53	8129	6334512	92.5627
8219	安沢	ヤスザワ	53	8129	6334565	92.5635
8220	谷部	ヤベ	53	8129	6334618	92.5643
8221	山地	ヤマチ	53	8129	6334671	92.5651
8222	湯舟	ユフネ	53	8129	6334724	92.5658
8223	余語	ヨゴ	53	8129	6334777	92.5666
8224	吉國	ヨシクニ	53	8129	6334830	92.5674
8225	吉葉	ヨシバ	53	8129	6334883	92.5682
8226	代永	ヨナガ	53	8129	6334936	92.5689
8227	若田	ワカタ	53	8129	6334989	92.5697
8228	鷲澤	ワシザワ	53	8129	6335042	92.5705
8229	藍	アイ	52	8229	6335094	92.5712
8230	相京	アイキヨウ	52	8229	6335146	92.572
8231	愛澤	アイザワ	52	8229	6335198	92.5728
8232	青谷	アオタニ	52	8229	6335250	92.5735
8233	青松	アオマツ	52	8229	6335302	92.5743
8234	穐元	アキモト	52	8229	6335354	92.575
8235	明智	アケチ	52	8229	6335406	92.5758
8236	朝隈	アサクマ	52	8229	6335458	92.5766
8237	伊計	イケイ	52	8229	6335510	92.5773
8238	池井	イケイ	52	8229	6335562	92.5781
8239	伊芸	イゲイ	52	8229	6335614	92.5788
8240	石切山	イシキリヤマ	52	8229	6335666	92.5796
8241	石黒	イシクロ	52	8229	6335718	92.5804
8242	井田倉	イタクラ	52	8229	6335770	92.5811
8243	依知川	イチカワ	52	8229	6335822	92.5819
8244	井手上	イデウエ	52	8229	6335874	92.5826
8245	糸瀬	イトセ	52	8229	6335926	92.5834
8246	今原	イマハラ	52	8229	6335978	92.5842
8247	今堀	イマホリ	52	8229	6336030	92.5849
8248	岩越	イワコシ	52	8229	6336082	92.5857
8249	梅島	ウメジマ	52	8229	6336134	92.5864
8250	大川内	オオカワウチ	52	8229	6336186	92.5872
8251	大鳥	オオトリ	52	8229	6336238	92.588
8252	岡添	オカゾエ	52	8229	6336290	92.5887
8253	柿谷	カキタニ	52	8229	6336342	92.5895
8254	柏山	カシヤマ	52	8229	6336394	92.5902
8255	数見	カズミ	52	8229	6336446	92.591
8256	金谷	カネヤ	52	8229	6336498	92.5918
8257	茅島	カヤシマ	52	8229	6336550	92.5925
8258	黄海	キウミ	52	8229	6336602	92.5933
8259	菊一	キクイチ	52	8229	6336654	92.594
8260	菊地原	キクチバラ	52	8229	6336706	92.5948
8261	行徳	ギヨウトク	52	8229	6336758	92.5956
8262	久家	クガ	52	8229	6336810	92.5963
8263	窪寺	クボテラ	52	8229	6336862	92.5971
8264	倉永	クラナガ	52	8229	6336914	92.5978
8265	小薗	コゾノ	52	8229	6336966	92.5986
8266	小堀	コホリ	52	8229	6337018	92.5994
8267	小溝	コミゾ	52	8229	6337070	92.6001
8268	齋田	サイダ	52	8229	6337122	92.6009
8269	笹口	ササグチ	52	8229	6337174	92.6016
8270	薩川	サツカワ	52	8229	6337226	92.6024
8271	塩野谷	シオノヤ	52	8229	6337278	92.6032
8272	島原	シマハラ	52	8229	6337330	92.6039
8273	肖	シヨウ	52	8229	6337382	92.6047
8274	白方	シラカタ	52	8229	6337434	92.6054
8275	城野	シロノ	52	8229	6337486	92.6062
8276	吹田	スイタ	52	8229	6337538	92.607
8277	砂辺	スナベ	52	8229	6337590	92.6077
8278	■岩	タカイワ	52	8229	6337642	92.6085
8279	高嶺	タカミネ	52	8229	6337694	92.6092
8280	瀧上	タキガミ	52	8229	6337746	92.61
8281	武子	タケシ	52	8229	6337798	92.6108
8282	竹生田	タコウダ	52	8229	6337850	92.6115
8283	館岡	タテオカ	52	8229	6337902	92.6123
8284	谷元	タニモト	52	8229	6337954	92.613
8285	谷屋	タニヤ	52	8229	6338006	92.6138
8286	茶圓	チヤエン	52	8229	6338058	92.6146
8287	柘植野	ツゲノ	52	8229	6338110	92.6153
8288	土倉	ツチクラ	52	8229	6338162	92.6161
8289	時岡	トキオカ	52	8229	6338214	92.6168
8290	豊増	トヨマス	52	8229	6338266	92.6176
8291	仲出川	ナカデガワ	52	8229	6338318	92.6184
8292	長束	ナガツカ	52	8229	6338370	92.6191
8293	長間	ナガマ	52	8229	6338422	92.6199
8294	菜花	ナバナ	52	8229	6338474	92.6206
8295	成本	ナリモト	52	8229	6338526	92.6214
8296	仁上	ニカミ	52	8229	6338578	92.6222
8297	錦戸	ニシキド	52	8229	6338630	92.6229
8298	西迫	ニシサコ	52	8229	6338682	92.6237
8299	能村	ノウムラ	52	8229	6338734	92.6244
8300	能代	ノシロ	52	8229	6338786	92.6252
8301	野々下	ノノシタ	52	8229	6338838	92.626
8302	信澤	ノブサワ	52	8229	6338890	92.6267
8303	乃美	ノミ	52	8229	6338942	92.6275
8304	張間	ハリマ	52	8229	6338994	92.6282
8305	伴場	バンバ	52	8229	6339046	92.629
8306	日下田	ヒゲタ	52	8229	6339098	92.6298
8307	平牧	ヒラマキ	52	8229	6339150	92.6305
8308	藤宮	フジミヤ	52	8229	6339202	92.6313
8309	降籏	フリハタ	52	8229	6339254	92.632
8310	古垣	フルガキ	52	8229	6339306	92.6328
8311	堀山	ホリヤマ	52	8229	6339358	92.6336
8312	前中	マエナカ	52	8229	6339410	92.6343
8313	牧元	マキモト	52	8229	6339462	92.6351
8314	正村	マサムラ	52	8229	6339514	92.6358
8315	松上	マツガミ	52	8229	6339566	92.6366
8316	松根	マツネ	52	8229	6339618	92.6374
8317	水梨	ミズナシ	52	8229	6339670	92.6381
8318	水野	ミヅノ	52	8229	6339722	92.6389
8319	三牧	ミマキ	52	8229	6339774	92.6396
8320	三■	ミヨシ	52	8229	6339826	92.6404
8321	向川	ムカイガワ	52	8229	6339878	92.6412
8322	麦倉	ムギクラ	52	8229	6339930	92.6419
8323	宗方	ムナカタ	52	8229	6339982	92.6427
8324	望田	モチダ	52	8229	6340034	92.6434
8325	桃田	モモタ	52	8229	6340086	92.6442
8326	守口	モリグチ	52	8229	6340138	92.645
8327	森瀬	モリセ	52	8229	6340190	92.6457
8328	森竹	モリタケ	52	8229	6340242	92.6465
8329	森平	モリヒラ	52	8229	6340294	92.6472
8330	梁取	ヤナトリ	52	8229	6340346	92.648
8331	鑓田	ヤリタ	52	8229	6340398	92.6488
8332	柚木	ユキ	52	8229	6340450	92.6495
8333	吉家	ヨシイエ	52	8229	6340502	92.6503
8334	善方	ヨシカタ	52	8229	6340554	92.651
8335	吉中	ヨシナカ	52	8229	6340606	92.6518
8336	米光	ヨネミツ	52	8229	6340658	92.6526
8337	脇川	ワキカワ	52	8229	6340710	92.6533
8338	安瀬	アンゼ	51	8338	6340761	92.6541
8339	李	イ−	51	8338	6340812	92.6548
8340	家入	イエイリ	51	8338	6340863	92.6555
8341	池端	イケバタ	51	8338	6340914	92.6563
8342	居城	イシロ	51	8338	6340965	92.657
8343	井沼	イヌマ	51	8338	6341016	92.6578
8344	岩内	イワウチ	51	8338	6341067	92.6585
8345	打木	ウチキ	51	8338	6341118	92.6593
8346	打矢	ウチヤ	51	8338	6341169	92.66
8347	宇津	ウツ	51	8338	6341220	92.6608
8348	浦元	ウラモト	51	8338	6341271	92.6615
8349	大仲	オオナカ	51	8338	6341322	92.6623
8350	大浪	オオナミ	51	8338	6341373	92.663
8351	岡地	オカチ	51	8338	6341424	92.6637
8352	岡留	オカドメ	51	8338	6341475	92.6645
8353	落	オチ	51	8338	6341526	92.6652
8354	小野関	オノゼキ	51	8338	6341577	92.666
8355	帯金	オビカネ	51	8338	6341628	92.6667
8356	片井	カタイ	51	8338	6341679	92.6675
8357	勝連	カツレン	51	8338	6341730	92.6682
8358	金屋	カナヤ	51	8338	6341781	92.669
8359	上別府	カミベツプ	51	8338	6341832	92.6697
8360	川南	カワミナミ	51	8338	6341883	92.6705
8361	喜屋武	キヤタケ	51	8338	6341934	92.6712
8362	清末	キヨスエ	51	8338	6341985	92.6719
8363	桐谷	キリタニ	51	8338	6342036	92.6727
8364	久賀	クガ	51	8338	6342087	92.6734
8365	河内山	コウチヤマ	51	8338	6342138	92.6742
8366	小手	コテ	51	8338	6342189	92.6749
8367	小桧山	コヒヤマ	51	8338	6342240	92.6757
8368	小水	コミズ	51	8338	6342291	92.6764
8369	西条	サイジヨウ	51	8338	6342342	92.6772
8370	佐方	サカタ	51	8338	6342393	92.6779
8371	柵山	サクヤマ	51	8338	6342444	92.6787
8372	志倉	シクラ	51	8338	6342495	92.6794
8373	重川	シゲカワ	51	8338	6342546	92.6801
8374	白垣	シラガキ	51	8338	6342597	92.6809
8375	白野	シラノ	51	8338	6342648	92.6816
8376	須賀田	スガタ	51	8338	6342699	92.6824
8377	菅又	スガマタ	51	8338	6342750	92.6831
8378	関藤	セキフジ	51	8338	6342801	92.6839
8379	瀬藤	セトウ	51	8338	6342852	92.6846
8380	瀬戸川	セトガワ	51	8338	6342903	92.6854
8381	苑田	ソノダ	51	8338	6342954	92.6861
8382	■城	タカシロ	51	8338	6343005	92.6868
8383	竹■	タケザキ	51	8338	6343056	92.6876
8384	武樋	タケヒ	51	8338	6343107	92.6883
8385	田附	タツキ	51	8338	6343158	92.6891
8386	太宰	ダザイ	51	8338	6343209	92.6898
8387	近	チカ	51	8338	6343260	92.6906
8388	月山	ツキヤマ	51	8338	6343311	92.6913
8389	常石	ツネイシ	51	8338	6343362	92.6921
8390	常田	ツネタ	51	8338	6343413	92.6928
8391	壷井	ツボイ	51	8338	6343464	92.6936
8392	津本	ツモト	51	8338	6343515	92.6943
8393	寺町	テラマチ	51	8338	6343566	92.695
8394	董	トウ	51	8338	6343617	92.6958
8395	豊澤	トヨサワ	51	8338	6343668	92.6965
8396	鳥潟	トリガタ	51	8338	6343719	92.6973
8397	中世古	ナカセコ	51	8338	6343770	92.698
8398	中部	ナカベ	51	8338	6343821	92.6988
8399	中邨	ナカムラ	51	8338	6343872	92.6995
8400	長池	ナガイケ	51	8338	6343923	92.7003
8401	長木	ナガキ	51	8338	6343974	92.701
8402	長塩	ナガシオ	51	8338	6344025	92.7018
8403	永嶺	ナガミネ	51	8338	6344076	92.7025
8404	七沢	ナナサワ	51	8338	6344127	92.7032
8405	名畑	ナハタ	51	8338	6344178	92.704
8406	新堀	ニイホリ	51	8338	6344229	92.7047
8407	韮澤	ニラサワ	51	8338	6344280	92.7055
8408	根市	ネイチ	51	8338	6344331	92.7062
8409	波田	ハダ	51	8338	6344382	92.707
8410	初田	ハツタ	51	8338	6344433	92.7077
8411	浜砂	ハマスナ	51	8338	6344484	92.7085
8412	羽村	ハムラ	51	8338	6344535	92.7092
8413	久留	ヒサドメ	51	8338	6344586	92.71
8414	肥田野	ヒダノ	51	8338	6344637	92.7107
8415	日向	ヒムカイ	51	8338	6344688	92.7114
8416	檜森	ヒモリ	51	8338	6344739	92.7122
8417	廣重	ヒロシゲ	51	8338	6344790	92.7129
8418	廣津	ヒロツ	51	8338	6344841	92.7137
8419	福中	フクナカ	51	8338	6344892	92.7144
8420	細金	ホソガネ	51	8338	6344943	92.7152
8421	堀篭	ホリゴメ	51	8338	6344994	92.7159
8422	前沢	マエサワ	51	8338	6345045	92.7167
8423	昌山	マサヤマ	51	8338	6345096	92.7174
8424	増山	マシヤマ	51	8338	6345147	92.7181
8425	斑目	マダラメ	51	8338	6345198	92.7189
8426	松室	マツムロ	51	8338	6345249	92.7196
8427	三間	ミツマ	51	8338	6345300	92.7204
8428	峯崎	ミネザキ	51	8338	6345351	92.7211
8429	宮津	ミヤツ	51	8338	6345402	92.7219
8430	宮津	ミヤヅ	51	8338	6345453	92.7226
8431	室野	ムロノ	51	8338	6345504	92.7234
8432	目良	メラ	51	8338	6345555	92.7241
8433	本柳	モトヤナギ	51	8338	6345606	92.7249
8434	柳村	ヤナギムラ	51	8338	6345657	92.7256
8435	米崎	ヨネザキ	51	8338	6345708	92.7263
8436	若木	ワカギ	51	8338	6345759	92.7271
8437	朝妻	アサツマ	50	8437	6345809	92.7278
8438	鮑子	アビコ	50	8437	6345859	92.7286
8439	安蒜	アンビル	50	8437	6345909	92.7293
8440	飯泉	イイイズミ	50	8437	6345959	92.73
8441	幾島	イクシマ	50	8437	6346009	92.7307
8442	石戸	イシト	50	8437	6346059	92.7315
8443	石引	イシビキ	50	8437	6346109	92.7322
8444	市堀	イチホリ	50	8437	6346159	92.7329
8445	稲津	イナヅ	50	8437	6346209	92.7337
8446	犬塚	イヌズカ	50	8437	6346259	92.7344
8447	伊與田	イヨダ	50	8437	6346309	92.7351
8448	岩嵜	イワサキ	50	8437	6346359	92.7359
8449	上中	ウエナカ	50	8437	6346409	92.7366
8450	氏田	ウジタ	50	8437	6346459	92.7373
8451	臼見	ウスミ	50	8437	6346509	92.7381
8452	梅内	ウメウチ	50	8437	6346559	92.7388
8453	江頭	エトウ	50	8437	6346609	92.7395
8454	大貝	オオガイ	50	8437	6346659	92.7402
8455	大作	オオサク	50	8437	6346709	92.741
8456	大薗	オオゾノ	50	8437	6346759	92.7417
8457	奥畑	オクハタ	50	8437	6346809	92.7424
8458	長船	オサフネ	50	8437	6346859	92.7432
8459	小瀬	オセ	50	8437	6346909	92.7439
8460	小田木	オダギ	50	8437	6346959	92.7446
8461	片貝	カタカイ	50	8437	6347009	92.7454
8462	片村	カタムラ	50	8437	6347059	92.7461
8463	門谷	カドタニ	50	8437	6347109	92.7468
8464	金塚	カナヅカ	50	8437	6347159	92.7475
8465	川隅	カワスミ	50	8437	6347209	92.7483
8466	川添	カワソエ	50	8437	6347259	92.749
8467	川竹	カワタケ	50	8437	6347309	92.7497
8468	岸下	キシシタ	50	8437	6347359	92.7505
8469	北上	キタガミ	50	8437	6347409	92.7512
8470	窪嶋	クボシマ	50	8437	6347459	92.7519
8471	栗谷川	クリヤガワ	50	8437	6347509	92.7527
8472	榑松	クレマツ	50	8437	6347559	92.7534
8473	黒原	クロハラ	50	8437	6347609	92.7541
8474	甲野	コウノ	50	8437	6347659	92.7549
8475	小貫	コヌキ	50	8437	6347709	92.7556
8476	桜川	サクラガワ	50	8437	6347759	92.7563
8477	笹瀬	ササセ	50	8437	6347809	92.757
8478	澤畠	サワハタ	50	8437	6347859	92.7578
8479	山藤	サントウ	50	8437	6347909	92.7585
8480	在間	ザイマ	50	8437	6347959	92.7592
8481	施	シ	50	8437	6348009	92.76
8482	塩	シオ	50	8437	6348059	92.7607
8483	塩満	シオミツ	50	8437	6348109	92.7614
8484	重藤	シゲトウ	50	8437	6348159	92.7622
8485	静	シズカ	50	8437	6348209	92.7629
8486	蔀	シトミ	50	8437	6348259	92.7636
8487	嶋谷	シマヤ	50	8437	6348309	92.7644
8488	白柳	シラヤナギ	50	8437	6348359	92.7651
8489	真貝	シンガイ	50	8437	6348409	92.7658
8490	鄭	ジヨン	50	8437	6348459	92.7665
8491	末野	スエノ	50	8437	6348509	92.7673
8492	巣山	スヤマ	50	8437	6348559	92.768
8493	雙田	ソウダ	50	8437	6348609	92.7687
8494	園木	ソノキ	50	8437	6348659	92.7695
8495	高市	タカイチ	50	8437	6348709	92.7702
8496	宅見	タクミ	50	8437	6348759	92.7709
8497	立澤	タツザワ	50	8437	6348809	92.7717
8498	種子島	タネガシマ	50	8437	6348859	92.7724
8499	団野	ダンノ	50	8437	6348909	92.7731
8500	中条	チユウジヨウ	50	8437	6348959	92.7739
8501	津上	ツガミ	50	8437	6349009	92.7746
8502	田遠	デンドウ	50	8437	6349059	92.7753
8503	戸泉	トイズミ	50	8437	6349109	92.776
8504	遠間	トオマ	50	8437	6349159	92.7768
8505	時崎	トキザキ	50	8437	6349209	92.7775
8506	■田	トクダ	50	8437	6349259	92.7782
8507	野老	トコロ	50	8437	6349309	92.779
8508	利根	トネ	50	8437	6349359	92.7797
8509	富高	トミタカ	50	8437	6349409	92.7804
8510	戸屋	トヤ	50	8437	6349459	92.7812
8511	仲井間	ナカイマ	50	8437	6349509	92.7819
8512	長岩	ナガイワ	50	8437	6349559	92.7826
8513	長妻	ナガツマ	50	8437	6349609	92.7833
8514	永守	ナガモリ	50	8437	6349659	92.7841
8515	名畑	ナバタ	50	8437	6349709	92.7848
8516	成山	ナリヤマ	50	8437	6349759	92.7855
8517	西田	ニシタ	50	8437	6349809	92.7863
8518	布田	ヌノダ	50	8437	6349859	92.787
8519	野谷	ノタニ	50	8437	6349909	92.7877
8520	羽角	ハスミ	50	8437	6349959	92.7885
8521	速見	ハヤミ	50	8437	6350009	92.7892
8522	久川	ヒサカワ	50	8437	6350059	92.7899
8523	菱谷	ヒシヤ	50	8437	6350109	92.7907
8524	舟根	フナネ	50	8437	6350159	92.7914
8525	伯耆	ホウキ	50	8437	6350209	92.7921
8526	外村	ホカムラ	50	8437	6350259	92.7928
8527	前橋	マエハシ	50	8437	6350309	92.7936
8528	松渕	マツブチ	50	8437	6350359	92.7943
8529	間橋	マバシ	50	8437	6350409	92.795
8530	蓑和	ミノワ	50	8437	6350459	92.7958
8531	宮副	ミヤゾエ	50	8437	6350509	92.7965
8532	三芳	ミヨシ	50	8437	6350559	92.7972
8533	迎田	ムカエダ	50	8437	6350609	92.798
8534	孟	モウ	50	8437	6350659	92.7987
8535	茂木	モキ	50	8437	6350709	92.7994
8536	百木	モモキ	50	8437	6350759	92.8002
8537	盛合	モリアイ	50	8437	6350809	92.8009
8538	守賀	モリガ	50	8437	6350859	92.8016
8539	森垣	モリガキ	50	8437	6350909	92.8023
8540	諸戸	モロト	50	8437	6350959	92.8031
8541	矢倉	ヤクラ	50	8437	6351009	92.8038
8542	箭子	ヤコ	50	8437	6351059	92.8045
8543	■沼	ヨシヌマ	50	8437	6351109	92.8053
8544	■元	ヨシモト	50	8437	6351159	92.806
8545	脇島	ワキシマ	50	8437	6351209	92.8067
8546	鷲沢	ワシザワ	50	8437	6351259	92.8075
8547	赤谷	アカタニ	49	8547	6351308	92.8082
8548	朝川	アサカワ	49	8547	6351357	92.8089
8549	安座間	アザマ	49	8547	6351406	92.8096
8550	阿部川	アベカワ	49	8547	6351455	92.8103
8551	荒明	アラアケ	49	8547	6351504	92.811
8552	有福	アリフク	49	8547	6351553	92.8118
8553	家城	イエキ	49	8547	6351602	92.8125
8554	生嶋	イクシマ	49	8547	6351651	92.8132
8555	石亀	イシガメ	49	8547	6351700	92.8139
8556	石光	イシミツ	49	8547	6351749	92.8146
8557	市倉	イチクラ	49	8547	6351798	92.8153
8558	一ノ関	イチノセキ	49	8547	6351847	92.8161
8559	稲津	イナツ	49	8547	6351896	92.8168
8560	稲野	イナノ	49	8547	6351945	92.8175
8561	犬塚	イヌツカ	49	8547	6351994	92.8182
8562	衣袋	イブクロ	49	8547	6352043	92.8189
8563	今山	イマヤマ	49	8547	6352092	92.8196
8564	猪山	イヤマ	49	8547	6352141	92.8203
8565	入村	イリムラ	49	8547	6352190	92.8211
8566	岩成	イワナリ	49	8547	6352239	92.8218
8567	岩鼻	イワハナ	49	8547	6352288	92.8225
8568	上田	ウエタ	49	8547	6352337	92.8232
8569	内城	ウチジヨウ	49	8547	6352386	92.8239
8570	枝野	エダノ	49	8547	6352435	92.8246
8571	大方	オオカタ	49	8547	6352484	92.8254
8572	大豆生田	オオマメウダ	49	8547	6352533	92.8261
8573	丘	オカ	49	8547	6352582	92.8268
8574	沖原	オキハラ	49	8547	6352631	92.8275
8575	尾坂	オサカ	49	8547	6352680	92.8282
8576	尾坂	オザカ	49	8547	6352729	92.8289
8577	小寺	オデラ	49	8547	6352778	92.8297
8578	海道	カイドウ	49	8547	6352827	92.8304
8579	賀来	カク	49	8547	6352876	92.8311
8580	霞	カスミ	49	8547	6352925	92.8318
8581	勝沢	カツザワ	49	8547	6352974	92.8325
8582	金村	カナムラ	49	8547	6353023	92.8332
8583	神代	カミシロ	49	8547	6353072	92.834
8584	上玉利	カミタマリ	49	8547	6353121	92.8347
8585	川床	カワトコ	49	8547	6353170	92.8354
8586	神吉	カンキ	49	8547	6353219	92.8361
8587	衣川	キヌカワ	49	8547	6353268	92.8368
8588	岐部	キベ	49	8547	6353317	92.8375
8589	熊谷	クマタニ	49	8547	6353366	92.8382
8590	倉津	クラツ	49	8547	6353415	92.839
8591	幸喜	コウキ	49	8547	6353464	92.8397
8592	■阪	コウサカ	49	8547	6353513	92.8404
8593	小日向	コビナタ	49	8547	6353562	92.8411
8594	■麗	コマ	49	8547	6353611	92.8418
8595	郷古	ゴウコ	49	8547	6353660	92.8425
8596	阪	サカ	49	8547	6353709	92.8433
8597	桜内	サクラウチ	49	8547	6353758	92.844
8598	佐谷	サタニ	49	8547	6353807	92.8447
8599	沢地	サワチ	49	8547	6353856	92.8454
8600	信濃	シナノ	49	8547	6353905	92.8461
8601	沈	シン	49	8547	6353954	92.8468
8602	新谷	シンガイ	49	8547	6354003	92.8476
8603	城後	ジヨウゴ	49	8547	6354052	92.8483
8604	神内	ジンナイ	49	8547	6354101	92.849
8605	曽田	ソタ	49	8547	6354150	92.8497
8606	高久	タカヒサ	49	8547	6354199	92.8504
8607	武安	タケヤス	49	8547	6354248	92.8511
8608	龍田	タツタ	49	8547	6354297	92.8519
8609	竜野	タツノ	49	8547	6354346	92.8526
8610	舘石	タテイシ	49	8547	6354395	92.8533
8611	近石	チカイシ	49	8547	6354444	92.854
8612	丁子	チヨウジ	49	8547	6354493	92.8547
8613	束田	ツカダ	49	8547	6354542	92.8554
8614	束野	ツカノ	49	8547	6354591	92.8561
8615	続木	ツヅキ	49	8547	6354640	92.8569
8616	勅使河原	テシガハラ	49	8547	6354689	92.8576
8617	寺元	テラモト	49	8547	6354738	92.8583
8618	桃原	トウバル	49	8547	6354787	92.859
8619	飛永	トビナガ	49	8547	6354836	92.8597
8620	鳥生	トリウ	49	8547	6354885	92.8604
8621	鳥毛	トリゲ	49	8547	6354934	92.8612
8622	中楯	ナカダテ	49	8547	6354983	92.8619
8623	長藤	ナガフジ	49	8547	6355032	92.8626
8624	長安	ナガヤス	49	8547	6355081	92.8633
8625	梨木	ナシキ	49	8547	6355130	92.864
8626	七宮	ナナミヤ	49	8547	6355179	92.8647
8627	鳴川	ナルカワ	49	8547	6355228	92.8655
8628	成嶋	ナルシマ	49	8547	6355277	92.8662
8629	野林	ノバヤシ	49	8547	6355326	92.8669
8630	濱井	ハマイ	49	8547	6355375	92.8676
8631	浜尾	ハマオ	49	8547	6355424	92.8683
8632	早矢仕	ハヤシ	49	8547	6355473	92.869
8633	早戸	ハヤト	49	8547	6355522	92.8698
8634	早藤	ハヤフジ	49	8547	6355571	92.8705
8635	春野	ハルノ	49	8547	6355620	92.8712
8636	東岡	ヒガシオカ	49	8547	6355669	92.8719
8637	日名子	ヒナゴ	49	8547	6355718	92.8726
8638	廣橋	ヒロハシ	49	8547	6355767	92.8733
8639	笛田	フエタ	49	8547	6355816	92.874
8640	福司	フクシ	49	8547	6355865	92.8748
8641	福屋	フクヤ	49	8547	6355914	92.8755
8642	福吉	フクヨシ	49	8547	6355963	92.8762
8643	福良	フクラ	49	8547	6356012	92.8769
8644	藤■	フジヨシ	49	8547	6356061	92.8776
8645	星合	ホシアイ	49	8547	6356110	92.8783
8646	細萱	ホソガヤ	49	8547	6356159	92.8791
8647	堀畑	ホリハタ	49	8547	6356208	92.8798
8648	本川	ホンカワ	49	8547	6356257	92.8805
8649	真塩	マシオ	49	8547	6356306	92.8812
8650	桝谷	マスヤ	49	8547	6356355	92.8819
8651	真庭	マニワ	49	8547	6356404	92.8826
8652	丸目	マルメ	49	8547	6356453	92.8834
8653	道岡	ミチオカ	49	8547	6356502	92.8841
8654	光石	ミツイシ	49	8547	6356551	92.8848
8655	三ツ石	ミツイシ	49	8547	6356600	92.8855
8656	峯山	ミネヤマ	49	8547	6356649	92.8862
8657	三保	ミホ	49	8547	6356698	92.8869
8658	森末	モリスエ	49	8547	6356747	92.8877
8659	諸澄	モロズミ	49	8547	6356796	92.8884
8660	八木岡	ヤギオカ	49	8547	6356845	92.8891
8661	薮崎	ヤブサキ	49	8547	6356894	92.8898
8662	山市	ヤマイチ	49	8547	6356943	92.8905
8663	行武	ユキタケ	49	8547	6356992	92.8912
8664	油布	ユフ	49	8547	6357041	92.8919
8665	廖	リヨウ	49	8547	6357090	92.8927
8666	若色	ワカイロ	49	8547	6357139	92.8934
8667	蕨	ワラビ	49	8547	6357188	92.8941
8668	藁谷	ワラヤ	49	8547	6357237	92.8948
8669	赤井田	アカイダ	48	8669	6357285	92.8955
8670	秋友	アキトモ	48	8669	6357333	92.8962
8671	甘田	アマダ	48	8669	6357381	92.8969
8672	阿見	アミ	48	8669	6357429	92.8976
8673	網本	アミモト	48	8669	6357477	92.8983
8674	鮎沢	アユザワ	48	8669	6357525	92.899
8675	有瀬	アリセ	48	8669	6357573	92.8997
8676	家子	イエコ	48	8669	6357621	92.9004
8677	家中	イエナカ	48	8669	6357669	92.9011
8678	池野谷	イケノヤ	48	8669	6357717	92.9018
8679	伊郷	イゴウ	48	8669	6357765	92.9025
8680	井嶋	イジマ	48	8669	6357813	92.9032
8681	井石	イセキ	48	8669	6357861	92.9039
8682	五十川	イソガワ	48	8669	6357909	92.9046
8683	礒田	イソダ	48	8669	6357957	92.9053
8684	稲部	イナベ	48	8669	6358005	92.906
8685	井元	イノモト	48	8669	6358053	92.9067
8686	伊林	イバヤシ	48	8669	6358101	92.9074
8687	岩■	イワザキ	48	8669	6358149	92.9081
8688	岩丸	イワマル	48	8669	6358197	92.9088
8689	上澤	ウエサワ	48	8669	6358245	92.9095
8690	内沢	ウチザワ	48	8669	6358293	92.9102
8691	宇塚	ウヅカ	48	8669	6358341	92.9109
8692	宇土	ウト	48	8669	6358389	92.9116
8693	宇野沢	ウノサワ	48	8669	6358437	92.9123
8694	越中谷	エツチユウヤ	48	8669	6358485	92.913
8695	大園	オオソノ	48	8669	6358533	92.9138
8696	大根	オオネ	48	8669	6358581	92.9145
8697	大牟田	オオムタ	48	8669	6358629	92.9152
8698	岡和田	オカワダ	48	8669	6358677	92.9159
8699	小蒲	オガマ	48	8669	6358725	92.9166
8700	尾村	オムラ	48	8669	6358773	92.9173
8701	蠣崎	カキザキ	48	8669	6358821	92.918
8702	笠野	カサノ	48	8669	6358869	92.9187
8703	梶尾	カジオ	48	8669	6358917	92.9194
8704	勝尾	カツオ	48	8669	6358965	92.9201
8705	要	カナメ	48	8669	6359013	92.9208
8706	金刺	カネザシ	48	8669	6359061	92.9215
8707	釜谷	カマヤ	48	8669	6359109	92.9222
8708	岸間	キシマ	48	8669	6359157	92.9229
8709	吉津	キツ	48	8669	6359205	92.9236
8710	桐木	キリキ	48	8669	6359253	92.9243
8711	儀保	ギボ	48	8669	6359301	92.925
8712	草■	クサナギ	48	8669	6359349	92.9257
8713	櫛谷	クシヤ	48	8669	6359397	92.9264
8714	国崎	クニサキ	48	8669	6359445	92.9271
8715	国定	クニサダ	48	8669	6359493	92.9278
8716	國光	クニミツ	48	8669	6359541	92.9285
8717	窪木	クボキ	48	8669	6359589	92.9292
8718	熊岡	クマオカ	48	8669	6359637	92.9299
8719	桑木	クワキ	48	8669	6359685	92.9306
8720	国生	コクシヨウ	48	8669	6359733	92.9313
8721	牛膓	ゴチヨウ	48	8669	6359781	92.932
8722	櫻澤	サクラザワ	48	8669	6359829	92.9327
8723	桜林	サクラバヤシ	48	8669	6359877	92.9334
8724	貞光	サダミツ	48	8669	6359925	92.9341
8725	塩畑	シオハタ	48	8669	6359973	92.9348
8726	重枝	シゲエダ	48	8669	6360021	92.9355
8727	白岩	シロイワ	48	8669	6360069	92.9362
8728	新名	シンミヨウ	48	8669	6360117	92.9369
8729	新免	シンメン	48	8669	6360165	92.9376
8730	杉橋	スギハシ	48	8669	6360213	92.9383
8731	鈴本	スズモト	48	8669	6360261	92.939
8732	鈴山	スズヤマ	48	8669	6360309	92.9397
8733	瑞慶覧	ズケラン	48	8669	6360357	92.9404
8734	瀬下	セジモ	48	8669	6360405	92.9411
8735	戴	タイ	48	8669	6360453	92.9418
8736	高柴	タカシバ	48	8669	6360501	92.9425
8737	多久島	タクシマ	48	8669	6360549	92.9432
8738	夛田	タダ	48	8669	6360597	92.9439
8739	秩父	チチブ	48	8669	6360645	92.9446
8740	中後	チユウゴ	48	8669	6360693	92.9453
8741	忠鉢	チユウバチ	48	8669	6360741	92.946
8742	政	ツカサ	48	8669	6360789	92.9467
8743	槌谷	ツチヤ	48	8669	6360837	92.9474
8744	津布久	ツブク	48	8669	6360885	92.9481
8745	坪崎	ツボサキ	48	8669	6360933	92.9488
8746	寺中	テラナカ	48	8669	6360981	92.9495
8747	出澤	デザワ	48	8669	6361029	92.9502
8748	戸井田	トイタ	48	8669	6361077	92.9509
8749	東瀬	トウセ	48	8669	6361125	92.9516
8750	都甲	トゴウ	48	8669	6361173	92.9523
8751	兎沢	トザワ	48	8669	6361221	92.953
8752	鳥畑	トリハタ	48	8669	6361269	92.9537
8753	中富	ナカトミ	48	8669	6361317	92.9544
8754	永海	ナガミ	48	8669	6361365	92.9551
8755	南保	ナンボ	48	8669	6361413	92.9558
8756	西下	ニシシタ	48	8669	6361461	92.9565
8757	根田	ネダ	48	8669	6361509	92.9572
8758	野里	ノザト	48	8669	6361557	92.9579
8759	野々垣	ノノガキ	48	8669	6361605	92.9586
8760	初鹿野	ハジカノ	48	8669	6361653	92.9593
8761	鳩貝	ハトガイ	48	8669	6361701	92.96
8762	花谷	ハナヤ	48	8669	6361749	92.9607
8763	張本	ハリモト	48	8669	6361797	92.9614
8764	樋野	ヒノ	48	8669	6361845	92.9621
8765	比良	ヒラ	48	8669	6361893	92.9628
8766	平江	ヒラエ	48	8669	6361941	92.9635
8767	平栗	ヒラクリ	48	8669	6361989	92.9643
8768	福武	フクタケ	48	8669	6362037	92.965
8769	古舘	フルタチ	48	8669	6362085	92.9657
8770	干川	ホシカワ	48	8669	6362133	92.9664
8771	堀端	ホリバタ	48	8669	6362181	92.9671
8772	政田	マサダ	48	8669	6362229	92.9678
8773	松野下	マツノシタ	48	8669	6362277	92.9685
8774	見沢	ミサワ	48	8669	6362325	92.9692
8775	道脇	ミチワキ	48	8669	6362373	92.9699
8776	宮倉	ミヤクラ	48	8669	6362421	92.9706
8777	宮瀬	ミヤセ	48	8669	6362469	92.9713
8778	宮間	ミヤマ	48	8669	6362517	92.972
8779	向中野	ムカイナカノ	48	8669	6362565	92.9727
8780	毛	モウ	48	8669	6362613	92.9734
8781	元■	モトヨシ	48	8669	6362661	92.9741
8782	盛本	モリモト	48	8669	6362709	92.9748
8783	諸星	モロボシ	48	8669	6362757	92.9755
8784	安ケ平	ヤスガヒラ	48	8669	6362805	92.9762
8785	安田	ヤスタ	48	8669	6362853	92.9769
8786	藪	ヤブ	48	8669	6362901	92.9776
8787	杠	ユズリハ	48	8669	6362949	92.9783
8788	芳崎	ヨシザキ	48	8669	6362997	92.979
8789	脇谷	ワキタニ	48	8669	6363045	92.9797
8790	浅妻	アサヅマ	47	8790	6363092	92.9804
8791	朝原	アサハラ	47	8790	6363139	92.9811
8792	畔柳	アゼヤナギ	47	8790	6363186	92.9817
8793	厚浦	アツウラ	47	8790	6363233	92.9824
8794	天城	アマギ	47	8790	6363280	92.9831
8795	天久	アメク	47	8790	6363327	92.9838
8796	飴谷	アメタニ	47	8790	6363374	92.9845
8797	鮎沢	アユサワ	47	8790	6363421	92.9852
8798	粟村	アワムラ	47	8790	6363468	92.9859
8799	池見	イケミ	47	8790	6363515	92.9865
8800	井下	イシタ	47	8790	6363562	92.9872
8801	和泉	イヅミ	47	8790	6363609	92.9879
8802	糸日谷	イトヒヤ	47	8790	6363656	92.9886
8803	糸谷	イトヤ	47	8790	6363703	92.9893
8804	稲永	イナナガ	47	8790	6363750	92.99
8805	岩口	イワグチ	47	8790	6363797	92.9907
8806	岩竹	イワタケ	47	8790	6363844	92.9914
8807	植月	ウエツキ	47	8790	6363891	92.992
8808	梅北	ウメキタ	47	8790	6363938	92.9927
8809	宇留間	ウルマ	47	8790	6363985	92.9934
8810	岡根	オカネ	47	8790	6364032	92.9941
8811	小滝	オダキ	47	8790	6364079	92.9948
8812	音田	オトダ	47	8790	6364126	92.9955
8813	恩地	オンチ	47	8790	6364173	92.9962
8814	鍵本	カギモト	47	8790	6364220	92.9969
8815	影沢	カゲサワ	47	8790	6364267	92.9975
8816	笠巻	カサマキ	47	8790	6364314	92.9982
8817	梶木	カジキ	47	8790	6364361	92.9989
8818	勝屋	カツヤ	47	8790	6364408	92.9996
8819	門岡	カドオカ	47	8790	6364455	93.0003
8820	椛木	カバキ	47	8790	6364502	93.001
8821	加茂川	カモガワ	47	8790	6364549	93.0017
8822	川倉	カワクラ	47	8790	6364596	93.0023
8823	関東	カントウ	47	8790	6364643	93.003
8824	桐渕	キリブチ	47	8790	6364690	93.0037
8825	桐村	キリムラ	47	8790	6364737	93.0044
8826	久代	クシロ	47	8790	6364784	93.0051
8827	久世	クセ	47	8790	6364831	93.0058
8828	久納	クノウ	47	8790	6364878	93.0065
8829	久芳	クバ	47	8790	6364925	93.0072
8830	蔵重	クラシゲ	47	8790	6364972	93.0078
8831	栗飯原	クリイイハラ	47	8790	6365019	93.0085
8832	栗沢	クリサワ	47	8790	6365066	93.0092
8833	慶徳	ケイトク	47	8790	6365113	93.0099
8834	小板	コイタ	47	8790	6365160	93.0106
8835	古謝	コジヤ	47	8790	6365207	93.0113
8836	小関	コゼキ	47	8790	6365254	93.012
8837	小蔦	コヅタ	47	8790	6365301	93.0126
8838	小牟田	コムタ	47	8790	6365348	93.0133
8839	五條	ゴジヨウ	47	8790	6365395	93.014
8840	齊田	サイタ	47	8790	6365442	93.0147
8841	斉野	サイノ	47	8790	6365489	93.0154
8842	坂蒔	サカマキ	47	8790	6365536	93.0161
8843	佐須田	サスダ	47	8790	6365583	93.0168
8844	定松	サダマツ	47	8790	6365630	93.0175
8845	佐和田	サワダ	47	8790	6365677	93.0181
8846	座本	ザモト	47	8790	6365724	93.0188
8847	塩路	シオジ	47	8790	6365771	93.0195
8848	重冨	シゲトミ	47	8790	6365818	93.0202
8849	茂山	シゲヤマ	47	8790	6365865	93.0209
8850	嶋森	シマモリ	47	8790	6365912	93.0216
8851	下垣	シモガキ	47	8790	6365959	93.0223
8852	下畑	シモハタ	47	8790	6366006	93.0229
8853	宿利	シユクリ	47	8790	6366053	93.0236
8854	白壁	シラカベ	47	8790	6366100	93.0243
8855	白瀧	シラタキ	47	8790	6366147	93.025
8856	居石	スエイシ	47	8790	6366194	93.0257
8857	菅俣	スガマタ	47	8790	6366241	93.0264
8858	周藤	スドウ	47	8790	6366288	93.0271
8859	曽原	ソハラ	47	8790	6366335	93.0278
8860	高塩	タカシオ	47	8790	6366382	93.0284
8861	高信	タカノブ	47	8790	6366429	93.0291
8862	■藤	タカフジ	47	8790	6366476	93.0298
8863	竹添	タケゾエ	47	8790	6366523	93.0305
8864	立入	タチイリ	47	8790	6366570	93.0312
8865	立岡	タテオカ	47	8790	6366617	93.0319
8866	田伏	タブセ	47	8790	6366664	93.0326
8867	近野	チカノ	47	8790	6366711	93.0333
8868	対木	ツイキ	47	8790	6366758	93.0339
8869	槌田	ツチダ	47	8790	6366805	93.0346
8870	圓谷	ツムラヤ	47	8790	6366852	93.0353
8871	筑城	ツユキ	47	8790	6366899	93.036
8872	■	トウ	47	8790	6366946	93.0367
8873	當眞	トウマ	47	8790	6366993	93.0374
8874	徳田	トクタ	47	8790	6367040	93.0381
8875	土倉	トクラ	47	8790	6367087	93.0387
8876	友寄	トモヨリ	47	8790	6367134	93.0394
8877	奈良崎	ナラサキ	47	8790	6367181	93.0401
8878	西戸	ニシド	47	8790	6367228	93.0408
8879	西前	ニシマエ	47	8790	6367275	93.0415
8880	塗木	ヌルキ	47	8790	6367322	93.0422
8881	初沢	ハツザワ	47	8790	6367369	93.0429
8882	初澤	ハツザワ	47	8790	6367416	93.0436
8883	浜地	ハマジ	47	8790	6367463	93.0442
8884	原本	ハラモト	47	8790	6367510	93.0449
8885	范	ハン	47	8790	6367557	93.0456
8886	日沖	ヒオキ	47	8790	6367604	93.0463
8887	広本	ヒロモト	47	8790	6367651	93.047
8888	藤武	フジタケ	47	8790	6367698	93.0477
8889	藤由	フジヨシ	47	8790	6367745	93.0484
8890	舩橋	フナバシ	47	8790	6367792	93.049
8891	保谷	ホタニ	47	8790	6367839	93.0497
8892	益本	マスモト	47	8790	6367886	93.0504
8893	間々田	ママダ	47	8790	6367933	93.0511
8894	美甘	ミカモ	47	8790	6367980	93.0518
8895	御子神	ミコガミ	47	8790	6368027	93.0525
8896	御園生	ミソノオ	47	8790	6368074	93.0532
8897	道野	ミチノ	47	8790	6368121	93.0539
8898	光瀬	ミツセ	47	8790	6368168	93.0545
8899	三笘	ミトマ	47	8790	6368215	93.0552
8900	峯宇	ミネウ	47	8790	6368262	93.0559
8901	美野	ミノ	47	8790	6368309	93.0566
8902	六角	ムスミ	47	8790	6368356	93.0573
8903	山来	ヤマキ	47	8790	6368403	93.058
8904	山島	ヤマシマ	47	8790	6368450	93.0587
8905	鑓溝	ヤリミゾ	47	8790	6368497	93.0593
8906	吉居	ヨシイ	47	8790	6368544	93.06
8907	■次	ヨシツグ	47	8790	6368591	93.0607
8908	■留	ヨシトメ	47	8790	6368638	93.0614
8909	■濱	ヨシハマ	47	8790	6368685	93.0621
8910	四柳	ヨツヤナギ	47	8790	6368732	93.0628
8911	與那覇	ヨナハ	47	8790	6368779	93.0635
8912	米林	ヨネバヤシ	47	8790	6368826	93.0642
8913	若竹	ワカタケ	47	8790	6368873	93.0648
8914	相賀	アイガ	46	8914	6368919	93.0655
8915	朝賀	アサカ	46	8914	6368965	93.0662
8916	雨谷	アマガイ	46	8914	6369011	93.0669
8917	天海	アマガイ	46	8914	6369057	93.0675
8918	安蔵	アンゾウ	46	8914	6369103	93.0682
8919	五十里	イカリ	46	8914	6369149	93.0689
8920	池ノ上	イケノウエ	46	8914	6369195	93.0695
8921	伊勢本	イセモト	46	8914	6369241	93.0702
8922	一澤	イチザワ	46	8914	6369287	93.0709
8923	一野	イチノ	46	8914	6369333	93.0716
8924	一守	イチモリ	46	8914	6369379	93.0722
8925	稲尾	イナオ	46	8914	6369425	93.0729
8926	因幡	イナバ	46	8914	6369471	93.0736
8927	今市	イマイチ	46	8914	6369517	93.0743
8928	今関	イマセキ	46	8914	6369563	93.0749
8929	林	イム	46	8914	6369609	93.0756
8930	居村	イムラ	46	8914	6369655	93.0763
8931	岩嶋	イワシマ	46	8914	6369701	93.0769
8932	岩城	イワシロ	46	8914	6369747	93.0776
8933	岩垂	イワダレ	46	8914	6369793	93.0783
8934	内河	ウチカワ	46	8914	6369839	93.079
8935	宇波	ウナミ	46	8914	6369885	93.0796
8936	梅元	ウメモト	46	8914	6369931	93.0803
8937	浦郷	ウラゴウ	46	8914	6369977	93.081
8938	浦谷	ウラタニ	46	8914	6370023	93.0816
8939	江下	エシタ	46	8914	6370069	93.0823
8940	越前屋	エチゼンヤ	46	8914	6370115	93.083
8941	江夏	エナツ	46	8914	6370161	93.0837
8942	王	オオ	46	8914	6370207	93.0843
8943	大寺	オオテラ	46	8914	6370253	93.085
8944	大牧	オオマキ	46	8914	6370299	93.0857
8945	沖島	オキシマ	46	8914	6370345	93.0864
8946	荻谷	オギヤ	46	8914	6370391	93.087
8947	奥沢	オクサワ	46	8914	6370437	93.0877
8948	生越	オゴセ	46	8914	6370483	93.0884
8949	尾曲	オマガリ	46	8914	6370529	93.089
8950	遠田	オンダ	46	8914	6370575	93.0897
8951	河合	カアイ	46	8914	6370621	93.0904
8952	笠	カサ	46	8914	6370667	93.0911
8953	笠羽	カサバ	46	8914	6370713	93.0917
8954	数馬	カズマ	46	8914	6370759	93.0924
8955	金岩	カナイワ	46	8914	6370805	93.0931
8956	神垣	カミガキ	46	8914	6370851	93.0937
8957	上戸	カミト	46	8914	6370897	93.0944
8958	亀島	カメシマ	46	8914	6370943	93.0951
8959	唐川	カラカワ	46	8914	6370989	93.0958
8960	官野	カンノ	46	8914	6371035	93.0964
8961	木船	キフネ	46	8914	6371081	93.0971
8962	肝付	キモツキ	46	8914	6371127	93.0978
8963	清見	キヨミ	46	8914	6371173	93.0985
8964	高阪	コウサカ	46	8914	6371219	93.0991
8965	越畑	コシハタ	46	8914	6371265	93.0998
8966	小谷	コダニ	46	8914	6371311	93.1005
8967	酒見	サカミ	46	8914	6371357	93.1011
8968	指籏	サシハタ	46	8914	6371403	93.1018
8969	里■	サトヨシ	46	8914	6371449	93.1025
8970	三野宮	サンノミヤ	46	8914	6371495	93.1032
8971	三本松	サンボンマツ	46	8914	6371541	93.1038
8972	椎屋	シイヤ	46	8914	6371587	93.1045
8973	下道	シタミチ	46	8914	6371633	93.1052
8974	志知	シチ	46	8914	6371679	93.1058
8975	島名	シマナ	46	8914	6371725	93.1065
8976	下藤	シモフジ	46	8914	6371771	93.1072
8977	城条	ジヨウジヨウ	46	8914	6371817	93.1079
8978	末長	スエナガ	46	8914	6371863	93.1085
8979	末森	スエモリ	46	8914	6371909	93.1092
8980	清木	セイキ	46	8914	6371955	93.1099
8981	添田	ソエタ	46	8914	6372001	93.1106
8982	高口	タカグチ	46	8914	6372047	93.1112
8983	高品	タカシナ	46	8914	6372093	93.1119
8984	武知	タケチ	46	8914	6372139	93.1126
8985	辰口	タツグチ	46	8914	6372185	93.1132
8986	太幡	タバタ	46	8914	6372231	93.1139
8987	大郷	ダイゴウ	46	8914	6372277	93.1146
8988	大徳	ダイトク	46	8914	6372323	93.1153
8989	珍田	チンダ	46	8914	6372369	93.1159
8990	津江	ツエ	46	8914	6372415	93.1166
8991	塚谷	ツカヤ	46	8914	6372461	93.1173
8992	月森	ツキモリ	46	8914	6372507	93.1179
8993	■屋	ツチヤ	46	8914	6372553	93.1186
8994	津藤	ツトウ	46	8914	6372599	93.1193
8995	露久保	ツユクボ	46	8914	6372645	93.12
8996	寺倉	テラクラ	46	8914	6372691	93.1206
8997	東本	トウモト	46	8914	6372737	93.1213
8998	東山	トウヤマ	46	8914	6372783	93.122
8999	徳安	トクヤス	46	8914	6372829	93.1227
9000	利川	トシカワ	46	8914	6372875	93.1233
9001	渡仲	トナカ	46	8914	6372921	93.124
9002	友枝	トモエダ	46	8914	6372967	93.1247
9003	友岡	トモオカ	46	8914	6373013	93.1253
9004	中峯	ナカミネ	46	8914	6373059	93.126
9005	永久	ナガヒサ	46	8914	6373105	93.1267
9006	波岡	ナミオカ	46	8914	6373151	93.1274
9007	浪瀬	ナミセ	46	8914	6373197	93.128
9008	奈良井	ナライ	46	8914	6373243	93.1287
9009	西橋	ニシハシ	46	8914	6373289	93.1294
9010	仁村	ニムラ	46	8914	6373335	93.13
9011	貫名	ヌキナ	46	8914	6373381	93.1307
9012	納所	ノウシヨ	46	8914	6373427	93.1314
9013	野堀	ノボリ	46	8914	6373473	93.1321
9014	野呂田	ノロタ	46	8914	6373519	93.1327
9015	灰野	ハイノ	46	8914	6373565	93.1334
9016	長谷場	ハセバ	46	8914	6373611	93.1341
9017	八森	ハチモリ	46	8914	6373657	93.1347
9018	原井	ハライ	46	8914	6373703	93.1354
9019	張ケ谷	ハリガヤ	46	8914	6373749	93.1361
9020	久留	ヒサトメ	46	8914	6373795	93.1368
9021	秀	ヒデ	46	8914	6373841	93.1374
9022	平畑	ヒラハタ	46	8914	6373887	93.1381
9023	廣	ヒロ	46	8914	6373933	93.1388
9024	日和佐	ヒワサ	46	8914	6373979	93.1395
9025	二又	フタマタ	46	8914	6374025	93.1401
9026	宝来	ホウライ	46	8914	6374071	93.1408
9027	保苅	ホカリ	46	8914	6374117	93.1415
9028	堀添	ホリゾエ	46	8914	6374163	93.1421
9029	前岡	マエオカ	46	8914	6374209	93.1428
9030	槙野	マキノ	46	8914	6374255	93.1435
9031	真柴	マシバ	46	8914	6374301	93.1442
9032	間杉	マスギ	46	8914	6374347	93.1448
9033	増茂	マスモ	46	8914	6374393	93.1455
9034	松薗	マツゾノ	46	8914	6374439	93.1462
9035	馬原	マハラ	46	8914	6374485	93.1468
9036	三門	ミカド	46	8914	6374531	93.1475
9037	見澤	ミサワ	46	8914	6374577	93.1482
9038	三柴	ミシバ	46	8914	6374623	93.1489
9039	溝手	ミゾテ	46	8914	6374669	93.1495
9040	水口	ミナグチ	46	8914	6374715	93.1502
9041	南本	ミナミモト	46	8914	6374761	93.1509
9042	宮■	ミヤダイ	46	8914	6374807	93.1516
9043	宮成	ミヤナリ	46	8914	6374853	93.1522
9044	向原	ムカイハラ	46	8914	6374899	93.1529
9045	棟方	ムネカタ	46	8914	6374945	93.1536
9046	毛木	モウギ	46	8914	6374991	93.1542
9047	森出	モリデ	46	8914	6375037	93.1549
9048	柳島	ヤナギシマ	46	8914	6375083	93.1556
9049	山成	ヤマナリ	46	8914	6375129	93.1563
9050	山林	ヤマバヤシ	46	8914	6375175	93.1569
9051	■	ユ	46	8914	6375221	93.1576
9052	■	ユウ	46	8914	6375267	93.1583
9053	遊作	ユウサク	46	8914	6375313	93.1589
9054	吉濱	ヨシハマ	46	8914	6375359	93.1596
9055	余田	ヨダ	46	8914	6375405	93.1603
9056	世永	ヨナガ	46	8914	6375451	93.161
9057	与那原	ヨナハラ	46	8914	6375497	93.1616
9058	米重	ヨネシゲ	46	8914	6375543	93.1623
9059	米津	ヨネツ	46	8914	6375589	93.163
9060	六川	ロクガワ	46	8914	6375635	93.1637
9061	鷲	ワシ	46	8914	6375681	93.1643
9062	明石	アカイシ	45	9062	6375726	93.165
9063	秋武	アキタケ	45	9062	6375771	93.1656
9064	安土	アヅチ	45	9062	6375816	93.1663
9065	網	アミ	45	9062	6375861	93.167
9066	荒城	アラキ	45	9062	6375906	93.1676
9067	新	アラタ	45	9062	6375951	93.1683
9068	有冨	アリトミ	45	9062	6375996	93.1689
9069	伊海	イカイ	45	9062	6376041	93.1696
9070	池元	イケモト	45	9062	6376086	93.1702
9071	和泉沢	イズミサワ	45	9062	6376131	93.1709
9072	今里	イマサト	45	9062	6376176	93.1716
9073	今出	イマデ	45	9062	6376221	93.1722
9074	藺牟田	イムタ	45	9062	6376266	93.1729
9075	入月	イリヅキ	45	9062	6376311	93.1735
9076	岩楯	イワタテ	45	9062	6376356	93.1742
9077	犬童	インドウ	45	9062	6376401	93.1748
9078	植	ウエ	45	9062	6376446	93.1755
9079	浮島	ウキシマ	45	9062	6376491	93.1762
9080	薄衣	ウスギ	45	9062	6376536	93.1768
9081	内池	ウチイケ	45	9062	6376581	93.1775
9082	内澤	ウチザワ	45	9062	6376626	93.1781
9083	梅森	ウメモリ	45	9062	6376671	93.1788
9084	枝並	エダナミ	45	9062	6376716	93.1794
9085	蛯谷	エビタニ	45	9062	6376761	93.1801
9086	大田黒	オオタグロ	45	9062	6376806	93.1808
9087	大津留	オオツル	45	9062	6376851	93.1814
9088	大隣	オオトナリ	45	9062	6376896	93.1821
9089	大盛	オオモリ	45	9062	6376941	93.1827
9090	岡坂	オカサカ	45	9062	6376986	93.1834
9091	小越	オゴシ	45	9062	6377031	93.1841
9092	尾尻	オジリ	45	9062	6377076	93.1847
9093	楓	カエデ	45	9062	6377121	93.1854
9094	掛橋	カケハシ	45	9062	6377166	93.186
9095	笠嶋	カサジマ	45	9062	6377211	93.1867
9096	笠谷	カサヤ	45	9062	6377256	93.1873
9097	片見	カタミ	45	9062	6377301	93.188
9098	金泉	カナイズミ	45	9062	6377346	93.1887
9099	金井塚	カナイヅカ	45	9062	6377391	93.1893
9100	金江	カナエ	45	9062	6377436	93.19
9101	兼坂	カネサカ	45	9062	6377481	93.1906
9102	鹿股	カノマタ	45	9062	6377526	93.1913
9103	釜	カマ	45	9062	6377571	93.1919
9104	亀村	カメムラ	45	9062	6377616	93.1926
9105	賀谷	カヤ	45	9062	6377661	93.1933
9106	河守	カワモリ	45	9062	6377706	93.1939
9107	丸藤	ガンドウ	45	9062	6377751	93.1946
9108	木坂	キサカ	45	9062	6377796	93.1952
9109	北平	キタヒラ	45	9062	6377841	93.1959
9110	喜友名	キユウナ	45	9062	6377886	93.1965
9111	久野	キユウノ	45	9062	6377931	93.1972
9112	清塚	キヨヅカ	45	9062	6377976	93.1979
9113	行田	ギヨウダ	45	9062	6378021	93.1985
9114	櫛原	クシハラ	45	9062	6378066	93.1992
9115	久住	クズミ	45	9062	6378111	93.1998
9116	熊代	クマシロ	45	9062	6378156	93.2005
9117	雲井	クモイ	45	9062	6378201	93.2011
9118	倉原	クラハラ	45	9062	6378246	93.2018
9119	車谷	クルマタニ	45	9062	6378291	93.2025
9120	桑木野	クワキノ	45	9062	6378336	93.2031
9121	小祝	コイワイ	45	9062	6378381	93.2038
9122	公平	コウダイラ	45	9062	6378426	93.2044
9123	香山	コウヤマ	45	9062	6378471	93.2051
9124	小上馬	コジヨウマ	45	9062	6378516	93.2058
9125	齋籐	サイトウ	45	9062	6378561	93.2064
9126	三溝	サミゾ	45	9062	6378606	93.2071
9127	澤崎	サワザキ	45	9062	6378651	93.2077
9128	色摩	シカマ	45	9062	6378696	93.2084
9129	島方	シマカタ	45	9062	6378741	93.209
9130	下郡	シモゴオリ	45	9062	6378786	93.2097
9131	新倉	シンクラ	45	9062	6378831	93.2104
9132	新道	シンドウ	45	9062	6378876	93.211
9133	末崎	スエザキ	45	9062	6378921	93.2117
9134	末政	スエマサ	45	9062	6378966	93.2123
9135	杉町	スギマチ	45	9062	6379011	93.213
9136	成	セイ	45	9062	6379056	93.2136
9137	瀧村	タキムラ	45	9062	6379101	93.2143
9138	田鹿	タジカ	45	9062	6379146	93.215
9139	田嶌	タジマ	45	9062	6379191	93.2156
9140	唯野	タダノ	45	9062	6379236	93.2163
9141	谷尾	タニオ	45	9062	6379281	93.2169
9142	田野辺	タノベ	45	9062	6379326	93.2176
9143	田畑	タハタ	45	9062	6379371	93.2182
9144	田畠	タバタ	45	9062	6379416	93.2189
9145	田牧	タマキ	45	9062	6379461	93.2196
9146	檀	ダン	45	9062	6379506	93.2202
9147	堤田	ツツミダ	45	9062	6379551	93.2209
9148	津野田	ツノダ	45	9062	6379596	93.2215
9149	寺部	テラベ	45	9062	6379641	93.2222
9150	当真	トウマ	45	9062	6379686	93.2228
9151	當銘	トウメ	45	9062	6379731	93.2235
9152	友澤	トモザワ	45	9062	6379776	93.2242
9153	中久木	ナカクキ	45	9062	6379821	93.2248
9154	仲佐	ナカサ	45	9062	6379866	93.2255
9155	中津留	ナカツル	45	9062	6379911	93.2261
9156	永崎	ナガサキ	45	9062	6379956	93.2268
9157	永濱	ナガハマ	45	9062	6380001	93.2275
9158	長谷	ナガヤ	45	9062	6380046	93.2281
9159	名護	ナゴ	45	9062	6380091	93.2288
9160	名島	ナジマ	45	9062	6380136	93.2294
9161	並松	ナミマツ	45	9062	6380181	93.2301
9162	二上	ニカミ	45	9062	6380226	93.2307
9163	西貝	ニシガイ	45	9062	6380271	93.2314
9164	西野入	ニシノイリ	45	9062	6380316	93.2321
9165	西濱	ニシハマ	45	9062	6380361	93.2327
9166	根石	ネイシ	45	9062	6380406	93.2334
9167	根崎	ネザキ	45	9062	6380451	93.234
9168	能見	ノウミ	45	9062	6380496	93.2347
9169	羽部	ハベ	45	9062	6380541	93.2353
9170	■■	ハマサキ	45	9062	6380586	93.236
9171	濱■	ハマザキ	45	9062	6380631	93.2367
9172	平島	ヒラジマ	45	9062	6380676	93.2373
9173	廣山	ヒロヤマ	45	9062	6380721	93.238
9174	普久原	フクハラ	45	9062	6380766	93.2386
9175	船曳	フナビキ	45	9062	6380811	93.2393
9176	布山	フヤマ	45	9062	6380856	93.2399
9177	古家	フルイエ	45	9062	6380901	93.2406
9178	古旗	フルハタ	45	9062	6380946	93.2413
9179	平敷	ヘシキ	45	9062	6380991	93.2419
9180	本宮	ホングウ	45	9062	6381036	93.2426
9181	本江	ホンゴウ	45	9062	6381081	93.2432
9182	曲山	マガリヤマ	45	9062	6381126	93.2439
9183	巻渕	マキブチ	45	9062	6381171	93.2445
9184	益井	マスイ	45	9062	6381216	93.2452
9185	益戸	マスド	45	9062	6381261	93.2459
9186	松縄	マツナワ	45	9062	6381306	93.2465
9187	美坂	ミサカ	45	9062	6381351	93.2472
9188	蓑原	ミノハラ	45	9062	6381396	93.2478
9189	三畑	ミハタ	45	9062	6381441	93.2485
9190	三松	ミマツ	45	9062	6381486	93.2492
9191	籾井	モミイ	45	9062	6381531	93.2498
9192	百々	モモ	45	9062	6381576	93.2505
9193	八百	ヤオ	45	9062	6381621	93.2511
9194	八百板	ヤオイタ	45	9062	6381666	93.2518
9195	八亀	ヤカメ	45	9062	6381711	93.2524
9196	矢込	ヤゴメ	45	9062	6381756	93.2531
9197	八城	ヤツシロ	45	9062	6381801	93.2538
9198	八ッ橋	ヤツハシ	45	9062	6381846	93.2544
9199	山蔭	ヤマカゲ	45	9062	6381891	93.2551
9200	山末	ヤマスエ	45	9062	6381936	93.2557
9201	油科	ユシナ	45	9062	6381981	93.2564
9202	好川	ヨシカワ	45	9062	6382026	93.257
9203	吉弘	ヨシヒロ	45	9062	6382071	93.2577
9204	寄田	ヨリタ	45	9062	6382116	93.2584
9205	萬谷	ヨロズヤ	45	9062	6382161	93.259
9206	李	リイ	45	9062	6382206	93.2597
9207	脇嶋	ワキシマ	45	9062	6382251	93.2603
9208	綿谷	ワタタニ	45	9062	6382296	93.261
9209	鰐川	ワニカワ	45	9062	6382341	93.2616
9210	和野	ワノ	45	9062	6382386	93.2623
9211	秋森	アキモリ	44	9211	6382430	93.2629
9212	明田	アケダ	44	9211	6382474	93.2636
9213	麻賀	アサガ	44	9211	6382518	93.2642
9214	熱方	アツカタ	44	9211	6382562	93.2649
9215	荒原	アラハラ	44	9211	6382606	93.2655
9216	石木田	イシキダ	44	9211	6382650	93.2662
9217	礒川	イソカワ	44	9211	6382694	93.2668
9218	磯ヶ谷	イソガヤ	44	9211	6382738	93.2674
9219	磯西	イソニシ	44	9211	6382782	93.2681
9220	磯脇	イソワキ	44	9211	6382826	93.2687
9221	一倉	イチクラ	44	9211	6382870	93.2694
9222	泉	イヅミ	44	9211	6382914	93.27
9223	伊比	イビ	44	9211	6382958	93.2707
9224	岩隈	イワクマ	44	9211	6383002	93.2713
9225	岩塚	イワツカ	44	9211	6383046	93.2719
9226	牛越	ウシコシ	44	9211	6383090	93.2726
9227	鵜塚	ウヅカ	44	9211	6383134	93.2732
9228	塩谷	エンヤ	44	9211	6383178	93.2739
9229	沖元	オキモト	44	9211	6383222	93.2745
9230	乙幡	オツハタ	44	9211	6383266	93.2752
9231	鬼形	オニガタ	44	9211	6383310	93.2758
9232	小野■	オノザキ	44	9211	6383354	93.2764
9233	小日向	オビナタ	44	9211	6383398	93.2771
9234	垣見	カキミ	44	9211	6383442	93.2777
9235	角屋	カクヤ	44	9211	6383486	93.2784
9236	帷子	カタビラ	44	9211	6383530	93.279
9237	勝原	カツハラ	44	9211	6383574	93.2797
9238	金海	カナウミ	44	9211	6383618	93.2803
9239	上澤	カミサワ	44	9211	6383662	93.2809
9240	河岸	カワギシ	44	9211	6383706	93.2816
9241	川並	カワナミ	44	9211	6383750	93.2822
9242	我満	ガマン	44	9211	6383794	93.2829
9243	北市	キタイチ	44	9211	6383838	93.2835
9244	清村	キヨムラ	44	9211	6383882	93.2842
9245	楠	クス	44	9211	6383926	93.2848
9246	沓名	クツナ	44	9211	6383970	93.2854
9247	久保埜	クボノ	44	9211	6384014	93.2861
9248	蔵原	クラハラ	44	9211	6384058	93.2867
9249	行田	コウダ	44	9211	6384102	93.2874
9250	小門	コカド	44	9211	6384146	93.288
9251	小藤田	コトウダ	44	9211	6384190	93.2887
9252	木幡	コバタ	44	9211	6384234	93.2893
9253	小檜山	コヒヤマ	44	9211	6384278	93.2899
9254	小梁川	コヤナガワ	44	9211	6384322	93.2906
9255	是松	コレマツ	44	9211	6384366	93.2912
9256	斎	サイ	44	9211	6384410	93.2919
9257	佐瀬	サゼ	44	9211	6384454	93.2925
9258	里井	サトイ	44	9211	6384498	93.2932
9259	佐鳥	サトリ	44	9211	6384542	93.2938
9260	柴尾	シバオ	44	9211	6384586	93.2944
9261	芝■	シバサキ	44	9211	6384630	93.2951
9262	霜越	シモコシ	44	9211	6384674	93.2957
9263	下沢	シモサワ	44	9211	6384718	93.2964
9264	下橋	シモハシ	44	9211	6384762	93.297
9265	下道	シモミチ	44	9211	6384806	93.2977
9266	正司	シヨウジ	44	9211	6384850	93.2983
9267	庄村	シヨウムラ	44	9211	6384894	93.2989
9268	水津	スイズ	44	9211	6384938	93.2996
9269	杉並	スギナミ	44	9211	6384982	93.3002
9270	杉之間	スギノマ	44	9211	6385026	93.3009
9271	祐川	スケガワ	44	9211	6385070	93.3015
9272	関和	セキワ	44	9211	6385114	93.3022
9273	仙北谷	センボクヤ	44	9211	6385158	93.3028
9274	善方	ゼンポウ	44	9211	6385202	93.3034
9275	曽谷	ソタニ	44	9211	6385246	93.3041
9276	外丸	ソトマル	44	9211	6385290	93.3047
9277	■藤	タカトウ	44	9211	6385334	93.3054
9278	■浪	タカナミ	44	9211	6385378	93.306
9279	高濱	タカハマ	44	9211	6385422	93.3067
9280	竹久保	タケクボ	44	9211	6385466	93.3073
9281	武隈	タケクマ	44	9211	6385510	93.308
9282	多勢	タセ	44	9211	6385554	93.3086
9283	竪山	タテヤマ	44	9211	6385598	93.3092
9284	種井	タネイ	44	9211	6385642	93.3099
9285	玉岡	タマオカ	44	9211	6385686	93.3105
9286	玉造	タマツクリ	44	9211	6385730	93.3112
9287	玉虫	タマムシ	44	9211	6385774	93.3118
9288	団	ダン	44	9211	6385818	93.3125
9289	檀上	ダンジヨウ	44	9211	6385862	93.3131
9290	陳	チエン	44	9211	6385906	93.3137
9291	塚川	ツカガワ	44	9211	6385950	93.3144
9292	塚平	ツカダイラ	44	9211	6385994	93.315
9293	辻丸	ツジマル	44	9211	6386038	93.3157
9294	角掛	ツノカケ	44	9211	6386082	93.3163
9295	角皆	ツノガイ	44	9211	6386126	93.317
9296	津森	ツモリ	44	9211	6386170	93.3176
9297	鶴留	ツルドメ	44	9211	6386214	93.3182
9298	出来	デキ	44	9211	6386258	93.3189
9299	東方	トウホウ	44	9211	6386302	93.3195
9300	東峰	トウミネ	44	9211	6386346	93.3202
9301	鳥取	トツトリ	44	9211	6386390	93.3208
9302	渡真利	トマリ	44	9211	6386434	93.3215
9303	富村	トミムラ	44	9211	6386478	93.3221
9304	土金	ドキン	44	9211	6386522	93.3227
9305	中井川	ナカイガワ	44	9211	6386566	93.3234
9306	中竹	ナカタケ	44	9211	6386610	93.324
9307	中平	ナカダイラ	44	9211	6386654	93.3247
9308	成見	ナルミ	44	9211	6386698	93.3253
9309	沼畑	ヌマハタ	44	9211	6386742	93.326
9310	根倉	ネグラ	44	9211	6386786	93.3266
9311	花香	ハナカ	44	9211	6386830	93.3272
9312	花谷	ハナタニ	44	9211	6386874	93.3279
9313	花原	ハナハラ	44	9211	6386918	93.3285
9314	羽二生	ハニウ	44	9211	6386962	93.3292
9315	飯田	ハンダ	44	9211	6387006	93.3298
9316	坂西	バンザイ	44	9211	6387050	93.3305
9317	平形	ヒラカタ	44	9211	6387094	93.3311
9318	平地	ヒラチ	44	9211	6387138	93.3317
9319	平藤	ヒラフジ	44	9211	6387182	93.3324
9320	弘津	ヒロツ	44	9211	6387226	93.333
9321	藤貫	フジヌキ	44	9211	6387270	93.3337
9322	二川	フタカワ	44	9211	6387314	93.3343
9323	二上	フタガミ	44	9211	6387358	93.335
9324	渕田	フチタ	44	9211	6387402	93.3356
9325	船井	フナイ	44	9211	6387446	93.3362
9326	星本	ホシモト	44	9211	6387490	93.3369
9327	真喜志	マキシ	44	9211	6387534	93.3375
9328	真嶋	マジマ	44	9211	6387578	93.3382
9329	松田	マツタ	44	9211	6387622	93.3388
9330	松矢	マツヤ	44	9211	6387666	93.3395
9331	的野	マトノ	44	9211	6387710	93.3401
9332	萬年	マンネン	44	9211	6387754	93.3407
9333	溝下	ミゾシタ	44	9211	6387798	93.3414
9334	美田	ミタ	44	9211	6387842	93.342
9335	光森	ミツモリ	44	9211	6387886	93.3427
9336	緑	ミドリ	44	9211	6387930	93.3433
9337	御法川	ミノリカワ	44	9211	6387974	93.344
9338	目羅	メラ	44	9211	6388018	93.3446
9339	茂泉	モイズミ	44	9211	6388062	93.3452
9340	本嶋	モトジマ	44	9211	6388106	93.3459
9341	盛屋	モリヤ	44	9211	6388150	93.3465
9342	薬師神	ヤクシジン	44	9211	6388194	93.3472
9343	矢羽田	ヤハタ	44	9211	6388238	93.3478
9344	山我	ヤマガ	44	9211	6388282	93.3485
9345	山見	ヤマミ	44	9211	6388326	93.3491
9346	矢守	ヤモリ	44	9211	6388370	93.3497
9347	湯佐	ユサ	44	9211	6388414	93.3504
9348	湯谷	ユタニ	44	9211	6388458	93.351
9349	横木	ヨコキ	44	9211	6388502	93.3517
9350	吉国	ヨシクニ	44	9211	6388546	93.3523
9351	■倉	ヨシクラ	44	9211	6388590	93.353
9352	吉行	ヨシユキ	44	9211	6388634	93.3536
9353	若野	ワカノ	44	9211	6388678	93.3542
9354	和木	ワキ	44	9211	6388722	93.3549
9355	青	アオ	43	9355	6388765	93.3555
9356	秋和	アキワ	43	9355	6388808	93.3561
9357	阿相	アソウ	43	9355	6388851	93.3568
9358	厚海	アツウミ	43	9355	6388894	93.3574
9359	天井	アマイ	43	9355	6388937	93.358
9360	天水	アマミズ	43	9355	6388980	93.3587
9361	飯嶌	イイジマ	43	9355	6389023	93.3593
9362	伊川	イカワ	43	9355	6389066	93.3599
9363	井澤	イサワ	43	9355	6389109	93.3605
9364	石場	イシバ	43	9355	6389152	93.3612
9365	石水	イシミズ	43	9355	6389195	93.3618
9366	板羽	イタバ	43	9355	6389238	93.3624
9367	伊南	イナミ	43	9355	6389281	93.3631
9368	犬伏	イヌブシ	43	9355	6389324	93.3637
9369	今島	イマジマ	43	9355	6389367	93.3643
9370	植杉	ウエスギ	43	9355	6389410	93.3649
9371	氏川	ウジカワ	43	9355	6389453	93.3656
9372	江木	エギ	43	9355	6389496	93.3662
9373	大岩根	オオイワネ	43	9355	6389539	93.3668
9374	大国	オオクニ	43	9355	6389582	93.3675
9375	大嶌	オオシマ	43	9355	6389625	93.3681
9376	大椛	オオナギ	43	9355	6389668	93.3687
9377	大仁田	オオニタ	43	9355	6389711	93.3693
9378	翁川	オキナガワ	43	9355	6389754	93.37
9379	鬼束	オニツカ	43	9355	6389797	93.3706
9380	小野島	オノジマ	43	9355	6389840	93.3712
9381	海野	カイノ	43	9355	6389883	93.3719
9382	帰山	カエリヤマ	43	9355	6389926	93.3725
9383	柿野	カキノ	43	9355	6389969	93.3731
9384	嘉代	カシロ	43	9355	6390012	93.3737
9385	叶内	カナウチ	43	9355	6390055	93.3744
9386	金崎	カナサキ	43	9355	6390098	93.375
9387	印牧	カネマキ	43	9355	6390141	93.3756
9388	亀■	カメザキ	43	9355	6390184	93.3762
9389	加門	カモン	43	9355	6390227	93.3769
9390	加谷	カヤ	43	9355	6390270	93.3775
9391	刈込	カリコミ	43	9355	6390313	93.3781
9392	川東	カワヒガシ	43	9355	6390356	93.3788
9393	川間	カワマ	43	9355	6390399	93.3794
9394	城内	キウチ	43	9355	6390442	93.38
9395	黄川田	キカワダ	43	9355	6390485	93.3806
9396	岸原	キシハラ	43	9355	6390528	93.3813
9397	木城	キシロ	43	9355	6390571	93.3819
9398	北岸	キタギシ	43	9355	6390614	93.3825
9399	北薗	キタゾノ	43	9355	6390657	93.3832
9400	京	キヨウ	43	9355	6390700	93.3838
9401	國谷	クニヤ	43	9355	6390743	93.3844
9402	黒岡	クロオカ	43	9355	6390786	93.385
9403	黒金	クロガネ	43	9355	6390829	93.3857
9404	桑沢	クワザワ	43	9355	6390872	93.3863
9405	国領	コクリヨウ	43	9355	6390915	93.3869
9406	越塚	コシヅカ	43	9355	6390958	93.3876
9407	小手川	コテガワ	43	9355	6391001	93.3882
9408	駒宮	コマミヤ	43	9355	6391044	93.3888
9409	古明地	コメイジ	43	9355	6391087	93.3894
9410	合津	ゴウツ	43	9355	6391130	93.3901
9411	五所	ゴシヨ	43	9355	6391173	93.3907
9412	佐合	サゴウ	43	9355	6391216	93.3913
9413	笹沢	ササザワ	43	9355	6391259	93.392
9414	佐分	サブリ	43	9355	6391302	93.3926
9415	椎木	シイノキ	43	9355	6391345	93.3932
9416	重見	シゲミ	43	9355	6391388	93.3938
9417	下迫	シモサコ	43	9355	6391431	93.3945
9418	出頭	シユツトウ	43	9355	6391474	93.3951
9419	白■	シラサキ	43	9355	6391517	93.3957
9420	城重	ジヨウジユウ	43	9355	6391560	93.3964
9421	末竹	スエタケ	43	9355	6391603	93.397
9422	須澤	スザワ	43	9355	6391646	93.3976
9423	鈴	スズ	43	9355	6391689	93.3982
9424	関下	セキシタ	43	9355	6391732	93.3989
9425	千代	センダイ	43	9355	6391775	93.3995
9426	■畠	タカハタ	43	9355	6391818	93.4001
9427	高見沢	タカミサワ	43	9355	6391861	93.4008
9428	滝内	タキウチ	43	9355	6391904	93.4014
9429	詫摩	タクマ	43	9355	6391947	93.402
9430	田面	タヅラ	43	9355	6391990	93.4026
9431	館	タテ	43	9355	6392033	93.4033
9432	棚町	タナマチ	43	9355	6392076	93.4039
9433	谷■	タニザキ	43	9355	6392119	93.4045
9434	谷森	タニモリ	43	9355	6392162	93.4052
9435	種岡	タネオカ	43	9355	6392205	93.4058
9436	千代延	チヨノブ	43	9355	6392248	93.4064
9437	土元	ツチモト	43	9355	6392291	93.407
9438	津吹	ツブキ	43	9355	6392334	93.4077
9439	天神	テンジン	43	9355	6392377	93.4083
9440	土信田	トシダ	43	9355	6392420	93.4089
9441	戸波	トナミ	43	9355	6392463	93.4096
9442	登山	トヤマ	43	9355	6392506	93.4102
9443	豊留	トヨドメ	43	9355	6392549	93.4108
9444	豊巻	トヨマキ	43	9355	6392592	93.4114
9445	鳥屋	トリヤ	43	9355	6392635	93.4121
9446	百目鬼	ドウメキ	43	9355	6392678	93.4127
9447	直野	ナオノ	43	9355	6392721	93.4133
9448	中城	ナカシロ	43	9355	6392764	93.4139
9449	永渕	ナガブチ	43	9355	6392807	93.4146
9450	新澤	ニイザワ	43	9355	6392850	93.4152
9451	能沢	ノザワ	43	9355	6392893	93.4158
9452	野部	ノベ	43	9355	6392936	93.4165
9453	萩元	ハギモト	43	9355	6392979	93.4171
9454	羽入	ハニユウ	43	9355	6393022	93.4177
9455	原中	ハラナカ	43	9355	6393065	93.4183
9456	久山	ヒサヤマ	43	9355	6393108	93.419
9457	姫田	ヒメダ	43	9355	6393151	93.4196
9458	平戸	ヒラド	43	9355	6393194	93.4202
9459	福里	フクザト	43	9355	6393237	93.4209
9460	藤生	フジオ	43	9355	6393280	93.4215
9461	富士原	フジワラ	43	9355	6393323	93.4221
9462	船崎	フナザキ	43	9355	6393366	93.4227
9463	古幡	フルハタ	43	9355	6393409	93.4234
9464	古海	フルミ	43	9355	6393452	93.424
9465	日置	ヘキ	43	9355	6393495	93.4246
9466	防後	ボウゴ	43	9355	6393538	93.4253
9467	坊野	ボウノ	43	9355	6393581	93.4259
9468	蒔苗	マキナエ	43	9355	6393624	93.4265
9469	松内	マツウチ	43	9355	6393667	93.4271
9470	文	ムン	43	9355	6393710	93.4278
9471	本永	モトナガ	43	9355	6393753	93.4284
9472	森廣	モリヒロ	43	9355	6393796	93.429
9473	諸藤	モロフジ	43	9355	6393839	93.4297
9474	八重尾	ヤエオ	43	9355	6393882	93.4303
9475	八田	ヤツダ	43	9355	6393925	93.4309
9476	八並	ヤツナミ	43	9355	6393968	93.4315
9477	芳本	ヨシモト	43	9355	6394011	93.4322
9478	鰐渕	ワニブチ	43	9355	6394054	93.4328
9479	赤枝	アカエダ	42	9479	6394096	93.4334
9480	秋枝	アキエダ	42	9479	6394138	93.434
9481	莇	アザミ	42	9479	6394180	93.4346
9482	安喰	アジキ	42	9479	6394222	93.4353
9483	穴吹	アナブキ	42	9479	6394264	93.4359
9484	阿波連	アハレン	42	9479	6394306	93.4365
9485	安納	アンノウ	42	9479	6394348	93.4371
9486	飯渕	イイブチ	42	9479	6394390	93.4377
9487	猪口	イグチ	42	9479	6394432	93.4383
9488	池■	イケザキ	42	9479	6394474	93.4389
9489	市木	イチキ	42	9479	6394516	93.4396
9490	市沢	イチザワ	42	9479	6394558	93.4402
9491	一藤木	イツトウギ	42	9479	6394600	93.4408
9492	猪浦	イノウラ	42	9479	6394642	93.4414
9493	伊丸岡	イマルオカ	42	9479	6394684	93.442
9494	岩片	イワカタ	42	9479	6394726	93.4426
9495	内舘	ウチダテ	42	9479	6394768	93.4432
9496	内林	ウチバヤシ	42	9479	6394810	93.4438
9497	大木	オオギ	42	9479	6394852	93.4445
9498	大庭	オオニワ	42	9479	6394894	93.4451
9499	大政	オオマサ	42	9479	6394936	93.4457
9500	尾沼	オヌマ	42	9479	6394978	93.4463
9501	親泊	オヤドマリ	42	9479	6395020	93.4469
9502	海津	カイツ	42	9479	6395062	93.4475
9503	鍵渡	カギワタ	42	9479	6395104	93.4481
9504	嘉門	カモン	42	9479	6395146	93.4488
9505	河鍋	カワナベ	42	9479	6395188	93.4494
9506	神定	カンジヨウ	42	9479	6395230	93.45
9507	貫洞	カンドウ	42	9479	6395272	93.4506
9508	木浦	キウラ	42	9479	6395314	93.4512
9509	喜田	キタ	42	9479	6395356	93.4518
9510	北方	キタカタ	42	9479	6395398	93.4524
9511	紀平	キヒラ	42	9479	6395440	93.4531
9512	忽那	クツナ	42	9479	6395482	93.4537
9513	國廣	クニヒロ	42	9479	6395524	93.4543
9514	黒森	クロモリ	42	9479	6395566	93.4549
9515	桑折	クワオリ	42	9479	6395608	93.4555
9516	源馬	ゲンマ	42	9479	6395650	93.4561
9517	■地	コウチ	42	9479	6395692	93.4567
9518	光山	コウヤマ	42	9479	6395734	93.4573
9519	興梠	コウロキ	42	9479	6395776	93.458
9520	腰原	コシハラ	42	9479	6395818	93.4586
9521	小太刀	コダチ	42	9479	6395860	93.4592
9522	小薮	コヤブ	42	9479	6395902	93.4598
9523	小渡	コワタリ	42	9479	6395944	93.4604
9524	齋	サイ	42	9479	6395986	93.461
9525	鷺坂	サギサカ	42	9479	6396028	93.4616
9526	提橋	サゲハシ	42	9479	6396070	93.4623
9527	里川	サトカワ	42	9479	6396112	93.4629
9528	佐分利	サブリ	42	9479	6396154	93.4635
9529	塩出	シオデ	42	9479	6396196	93.4641
9530	茂村	シゲムラ	42	9479	6396238	93.4647
9531	柴岡	シバオカ	42	9479	6396280	93.4653
9532	宿野部	シユクノベ	42	9479	6396322	93.4659
9533	庄内	シヨウナイ	42	9479	6396364	93.4666
9534	新家	シンケ	42	9479	6396406	93.4672
9535	新美	シンミ	42	9479	6396448	93.4678
9536	謝花	ジヤハナ	42	9479	6396490	93.4684
9537	前	ススメ	42	9479	6396532	93.469
9538	鈴井	スズイ	42	9479	6396574	93.4696
9539	首藤	ストウ	42	9479	6396616	93.4702
9540	住井	スミイ	42	9479	6396658	93.4709
9541	外木	ソトキ	42	9479	6396700	93.4715
9542	外村	ソトムラ	42	9479	6396742	93.4721
9543	高荒	タカアラ	42	9479	6396784	93.4727
9544	高堰	タカセキ	42	9479	6396826	93.4733
9545	高添	タカゾエ	42	9479	6396868	93.4739
9546	嵩原	タケハラ	42	9479	6396910	93.4745
9547	■野	タダノ	42	9479	6396952	93.4751
9548	立谷	タチヤ	42	9479	6396994	93.4758
9549	楯岡	タテオカ	42	9479	6397036	93.4764
9550	舘下	タテシタ	42	9479	6397078	93.477
9551	棚倉	タナクラ	42	9479	6397120	93.4776
9552	棚谷	タナヤ	42	9479	6397162	93.4782
9553	垂井	タルイ	42	9479	6397204	93.4788
9554	蔦谷	ツタヤ	42	9479	6397246	93.4794
9555	黒葛原	ツヅラハラ	42	9479	6397288	93.4801
9556	鶴本	ツルモト	42	9479	6397330	93.4807
9557	天白	テンパク	42	9479	6397372	93.4813
9558	東島	トウジマ	42	9479	6397414	93.4819
9559	遠竹	トオタケ	42	9479	6397456	93.4825
9560	時松	トキマツ	42	9479	6397498	93.4831
9561	渡久山	トクヤマ	42	9479	6397540	93.4837
9562	戸舘	トダテ	42	9479	6397582	93.4844
9563	留目	トドメ	42	9479	6397624	93.485
9564	飛嶋	トビシマ	42	9479	6397666	93.4856
9565	富木	トミキ	42	9479	6397708	93.4862
9566	冨吉	トミヨシ	42	9479	6397750	93.4868
9567	中沼	ナカヌマ	42	9479	6397792	93.4874
9568	中宮	ナカミヤ	42	9479	6397834	93.488
9569	中吉	ナカヨシ	42	9479	6397876	93.4886
9570	波形	ナミガタ	42	9479	6397918	93.4893
9571	新妻	ニイズマ	42	9479	6397960	93.4899
9572	錦織	ニシコリ	42	9479	6398002	93.4905
9573	仁部	ニベ	42	9479	6398044	93.4911
9574	貫井	ヌキイ	42	9479	6398086	93.4917
9575	布谷	ヌノタニ	42	9479	6398128	93.4923
9576	納富	ノウドミ	42	9479	6398170	93.4929
9577	萩島	ハギシマ	42	9479	6398212	93.4936
9578	初谷	ハツガイ	42	9479	6398254	93.4942
9579	葉梨	ハナシ	42	9479	6398296	93.4948
9580	濱谷	ハマヤ	42	9479	6398338	93.4954
9581	播摩	ハリマ	42	9479	6398380	93.496
9582	阪東	バンドウ	42	9479	6398422	93.4966
9583	日色	ヒイロ	42	9479	6398464	93.4972
9584	左伴	ヒダリトモ	42	9479	6398506	93.4979
9585	平河	ヒラカワ	42	9479	6398548	93.4985
9586	広浜	ヒロハマ	42	9479	6398590	93.4991
9587	富川	フカワ	42	9479	6398632	93.4997
9588	福安	フクヤス	42	9479	6398674	93.5003
9589	二口	フタクチ	42	9479	6398716	93.5009
9590	不動	フドウ	42	9479	6398758	93.5015
9591	星出	ホシデ	42	9479	6398800	93.5022
9592	細山田	ホソヤマダ	42	9479	6398842	93.5028
9593	本保	ホンポ	42	9479	6398884	93.5034
9594	前之園	マエノソノ	42	9479	6398926	93.504
9595	巻嶋	マキシマ	42	9479	6398968	93.5046
9596	眞下	マシモ	42	9479	6399010	93.5052
9597	又木	マタキ	42	9479	6399052	93.5058
9598	水浦	ミズウラ	42	9479	6399094	93.5064
9599	満井	ミツイ	42	9479	6399136	93.5071
9600	南谷	ミナミヤ	42	9479	6399178	93.5077
9601	峯木	ミネキ	42	9479	6399220	93.5083
9602	峯野	ミネノ	42	9479	6399262	93.5089
9603	美濃本	ミノモト	42	9479	6399304	93.5095
9604	宮野入	ミヤノイリ	42	9479	6399346	93.5101
9605	美山	ミヤマ	42	9479	6399388	93.5107
9606	明瀬	ミヨウセ	42	9479	6399430	93.5114
9607	村吉	ムラヨシ	42	9479	6399472	93.512
9608	室星	ムロホシ	42	9479	6399514	93.5126
9609	守部	モリベ	42	9479	6399556	93.5132
9610	師田	モロタ	42	9479	6399598	93.5138
9611	薬師	ヤクシ	42	9479	6399640	93.5144
9612	谷内田	ヤチダ	42	9479	6399682	93.515
9613	谷津田	ヤツダ	42	9479	6399724	93.5157
9614	矢橋	ヤハシ	42	9479	6399766	93.5163
9615	矢幅	ヤハバ	42	9479	6399808	93.5169
9616	山蔦	ヤマツタ	42	9479	6399850	93.5175
9617	山守	ヤマモリ	42	9479	6399892	93.5181
9618	山吉	ヤマヨシ	42	9479	6399934	93.5187
9619	湯座	ユザ	42	9479	6399976	93.5193
9620	弓野	ユミノ	42	9479	6400018	93.5199
9621	百合野	ユリノ	42	9479	6400060	93.5206
9622	好井	ヨシイ	42	9479	6400102	93.5212
9623	■越	ヨシコシ	42	9479	6400144	93.5218
9624	藍沢	アイザワ	41	9624	6400185	93.5224
9625	有永	アリナガ	41	9624	6400226	93.523
9626	阿波野	アワノ	41	9624	6400267	93.5236
9627	伊賀上	イガウエ	41	9624	6400308	93.5242
9628	井倉	イグラ	41	9624	6400349	93.5248
9629	池守	イケモリ	41	9624	6400390	93.5254
9630	井駒	イコマ	41	9624	6400431	93.526
9631	板津	イタヅ	41	9624	6400472	93.5266
9632	伊坪	イツボ	41	9624	6400513	93.5272
9633	伊豫田	イヨダ	41	9624	6400554	93.5278
9634	上羽	ウエバ	41	9624	6400595	93.5284
9635	宇佐	ウサ	41	9624	6400636	93.529
9636	後	ウシロ	41	9624	6400677	93.5296
9637	梅内	ウメナイ	41	9624	6400718	93.5302
9638	栄田	エイダ	41	9624	6400759	93.5308
9639	大築	オオツキ	41	9624	6400800	93.5314
9640	小野里	オノサト	41	9624	6400841	93.532
9641	尾又	オマタ	41	9624	6400882	93.5326
9642	織部	オリベ	41	9624	6400923	93.5332
9643	折目	オリメ	41	9624	6400964	93.5338
9644	温	オン	41	9624	6401005	93.5344
9645	貝谷	カイヤ	41	9624	6401046	93.535
9646	嘉悦	カエツ	41	9624	6401087	93.5356
9647	片川	カタガワ	41	9624	6401128	93.5362
9648	葛山	カツラヤマ	41	9624	6401169	93.5368
9649	鹿糠	カヌカ	41	9624	6401210	93.5374
9650	金長	カネナガ	41	9624	6401251	93.538
9651	壁島	カベシマ	41	9624	6401292	93.5386
9652	上嶋	カミジマ	41	9624	6401333	93.5392
9653	賀茂	カモ	41	9624	6401374	93.5398
9654	河住	カワスミ	41	9624	6401415	93.5404
9655	川根	カワネ	41	9624	6401456	93.541
9656	神庭	カンバ	41	9624	6401497	93.5416
9657	菊	キク	41	9624	6401538	93.5422
9658	北川	キタカワ	41	9624	6401579	93.5428
9659	北西	キタニシ	41	9624	6401620	93.5434
9660	橘■	キツタカ	41	9624	6401661	93.544
9661	陸	クガ	41	9624	6401702	93.5446
9662	久志	クシ	41	9624	6401743	93.5452
9663	櫛間	クシマ	41	9624	6401784	93.5458
9664	楠目	クスメ	41	9624	6401825	93.5464
9665	国仲	クニナカ	41	9624	6401866	93.547
9666	久保島	クボシマ	41	9624	6401907	93.5476
9667	久保庭	クボニワ	41	9624	6401948	93.5481
9668	倉繁	クラシゲ	41	9624	6401989	93.5487
9669	倉谷	クラヤ	41	9624	6402030	93.5493
9670	鯉江	コイエ	41	9624	6402071	93.5499
9671	高地	コウチ	41	9624	6402112	93.5505
9672	神谷	コウヤ	41	9624	6402153	93.5511
9673	小桜	コザクラ	41	9624	6402194	93.5517
9674	越沼	コシヌマ	41	9624	6402235	93.5523
9675	琴寄	コトヨリ	41	9624	6402276	93.5529
9676	米田	コメダ	41	9624	6402317	93.5535
9677	七種	サイクサ	41	9624	6402358	93.5541
9678	阪下	サカシタ	41	9624	6402399	93.5547
9679	坂詰	サカツメ	41	9624	6402440	93.5553
9680	鷺谷	サギタニ	41	9624	6402481	93.5559
9681	桜	サクラ	41	9624	6402522	93.5565
9682	定方	サダカタ	41	9624	6402563	93.5571
9683	渋澤	シブサワ	41	9624	6402604	93.5577
9684	嶋内	シマウチ	41	9624	6402645	93.5583
9685	島口	シマグチ	41	9624	6402686	93.5589
9686	下尾	シモオ	41	9624	6402727	93.5595
9687	下向	シモムカイ	41	9624	6402768	93.5601
9688	進士	シンシ	41	9624	6402809	93.5607
9689	祐川	スケカワ	41	9624	6402850	93.5613
9690	数藤	スドウ	41	9624	6402891	93.5619
9691	隅野	スミノ	41	9624	6402932	93.5625
9692	■川	セガワ	41	9624	6402973	93.5631
9693	関内	セキウチ	41	9624	6403014	93.5637
9694	銭	セン	41	9624	6403055	93.5643
9695	傍島	ソバジマ	41	9624	6403096	93.5649
9696	■谷	タカタニ	41	9624	6403137	93.5655
9697	高玉	タカタマ	41	9624	6403178	93.5661
9698	■徳	タカトク	41	9624	6403219	93.5667
9699	■信	タカノブ	41	9624	6403260	93.5673
9700	竹居	タケイ	41	9624	6403301	93.5679
9701	垂見	タルミ	41	9624	6403342	93.5685
9702	反田	タンダ	41	9624	6403383	93.5691
9703	千賀	チガ	41	9624	6403424	93.5697
9704	築城	ツイキ	41	9624	6403465	93.5703
9705	辻谷	ツジタニ	41	9624	6403506	93.5709
9706	伝法	デンポウ	41	9624	6403547	93.5715
9707	徳嶺	トクミネ	41	9624	6403588	93.5721
9708	豊島	トシマ	41	9624	6403629	93.5727
9709	冨■	トミタカ	41	9624	6403670	93.5733
9710	中市	ナカイチ	41	9624	6403711	93.5739
9711	中三川	ナカミガワ	41	9624	6403752	93.5745
9712	中満	ナカミツ	41	9624	6403793	93.5751
9713	楢島	ナラシマ	41	9624	6403834	93.5757
9714	成勢	ナルセ	41	9624	6403875	93.5763
9715	南城	ナンジヨウ	41	9624	6403916	93.5769
9716	南木	ナンモク	41	9624	6403957	93.5775
9717	新出	ニイデ	41	9624	6403998	93.5781
9718	新家	ニイノミ	41	9624	6404039	93.5787
9719	二川原	ニガワラ	41	9624	6404080	93.5793
9720	布宮	ヌノミヤ	41	9624	6404121	93.5799
9721	根塚	ネヅカ	41	9624	6404162	93.5805
9722	埜口	ノグチ	41	9624	6404203	93.5811
9723	野町	ノマチ	41	9624	6404244	93.5817
9724	羽毛田	ハケタ	41	9624	6404285	93.5823
9725	箱■	ハコザキ	41	9624	6404326	93.5829
9726	枦山	ハゼヤマ	41	9624	6404367	93.5835
9727	花川	ハナカワ	41	9624	6404408	93.5841
9728	羽生	ハニウ	41	9624	6404449	93.5847
9729	濱地	ハマチ	41	9624	6404490	93.5853
9730	浜西	ハマニシ	41	9624	6404531	93.5859
9731	萬代	バンダイ	41	9624	6404572	93.5865
9732	久井	ヒサイ	41	9624	6404613	93.5871
9733	久田	ヒサタ	41	9624	6404654	93.5877
9734	平崎	ヒラサキ	41	9624	6404695	93.5883
9735	平根	ヒラネ	41	9624	6404736	93.5889
9736	尾留川	ビルカワ	41	9624	6404777	93.5895
9737	福居	フクイ	41	9624	6404818	93.5901
9738	渕辺	フチベ	41	9624	6404859	93.5907
9739	毒島	ブスジマ	41	9624	6404900	93.5913
9740	保谷	ホウヤ	41	9624	6404941	93.5919
9741	保土田	ホトダ	41	9624	6404982	93.5925
9742	前谷	マエタニ	41	9624	6405023	93.5931
9743	真垣	マガキ	41	9624	6405064	93.5937
9744	松原	マツハラ	41	9624	6405105	93.5943
9745	真子	マナゴ	41	9624	6405146	93.5949
9746	三鬼	ミキ	41	9624	6405187	93.5955
9747	満園	ミツゾノ	41	9624	6405228	93.5961
9748	満留	ミツドメ	41	9624	6405269	93.5967
9749	光成	ミツナリ	41	9624	6405310	93.5973
9750	三俣	ミツマタ	41	9624	6405351	93.5979
9751	宮司	ミヤジ	41	9624	6405392	93.5985
9752	村治	ムラジ	41	9624	6405433	93.5991
9753	毛内	モウナイ	41	9624	6405474	93.5997
9754	盛川	モリカワ	41	9624	6405515	93.6003
9755	毛呂	モロ	41	9624	6405556	93.6009
9756	八杉	ヤスギ	41	9624	6405597	93.6015
9757	野内	ヤナイ	41	9624	6405638	93.6021
9758	柳舘	ヤナギダテ	41	9624	6405679	93.6027
9759	山重	ヤマシゲ	41	9624	6405720	93.6033
9760	行本	ユキモト	41	9624	6405761	93.6039
9761	横岡	ヨコオカ	41	9624	6405802	93.6045
9762	吉長	ヨシナガ	41	9624	6405843	93.6051
9763	四倉	ヨツクラ	41	9624	6405884	93.6057
9764	与那城	ヨナシロ	41	9624	6405925	93.6063
9765	若江	ワカエ	41	9624	6405966	93.6069
9766	鷲崎	ワシザキ	41	9624	6406007	93.6075
9767	鷲塚	ワシヅカ	41	9624	6406048	93.6081
9768	割石	ワリイシ	41	9624	6406089	93.6087
9769	相子	アイコ	40	9769	6406129	93.6092
9770	相野谷	アイノヤ	40	9769	6406169	93.6098
9771	浅村	アサムラ	40	9769	6406209	93.6104
9772	安谷屋	アダニヤ	40	9769	6406249	93.611
9773	天岸	アマギシ	40	9769	6406289	93.6116
9774	荒畑	アラハタ	40	9769	6406329	93.6122
9775	蟻坂	アリサカ	40	9769	6406369	93.6128
9776	有波	アリナミ	40	9769	6406409	93.6133
9777	伊神	イガミ	40	9769	6406449	93.6139
9778	池ノ谷	イケノヤ	40	9769	6406489	93.6145
9779	磯谷	イソタニ	40	9769	6406529	93.6151
9780	一ノ木	イチノキ	40	9769	6406569	93.6157
9781	糸洲	イトス	40	9769	6406609	93.6163
9782	稲玉	イナダマ	40	9769	6406649	93.6168
9783	稲辺	イナベ	40	9769	6406689	93.6174
9784	庵原	イハラ	40	9769	6406729	93.618
9785	今尾	イマオ	40	9769	6406769	93.6186
9786	井町	イマチ	40	9769	6406809	93.6192
9787	入井	イリイ	40	9769	6406849	93.6198
9788	入田	イリタ	40	9769	6406889	93.6204
9789	岩武	イワタケ	40	9769	6406929	93.6209
9790	氏家	ウジケ	40	9769	6406969	93.6215
9791	宇治橋	ウジハシ	40	9769	6407009	93.6221
9792	内原	ウチハラ	40	9769	6407049	93.6227
9793	采女	ウネメ	40	9769	6407089	93.6233
9794	浦壁	ウラカベ	40	9769	6407129	93.6239
9795	永楽	エイラク	40	9769	6407169	93.6244
9796	追分	オイワケ	40	9769	6407209	93.625
9797	大城	オオギ	40	9769	6407249	93.6256
9798	扇田	オオギダ	40	9769	6407289	93.6262
9799	大栗	オオクリ	40	9769	6407329	93.6268
9800	大嵩	オオタカ	40	9769	6407369	93.6274
9801	大堂	オオドウ	40	9769	6407409	93.6279
9802	大星	オオボシ	40	9769	6407449	93.6285
9803	音田	オンダ	40	9769	6407489	93.6291
9804	柏尾	カシオ	40	9769	6407529	93.6297
9805	鹿島田	カシマダ	40	9769	6407569	93.6303
9806	加治佐	カジサ	40	9769	6407609	93.6309
9807	勝澤	カツザワ	40	9769	6407649	93.6315
9808	勝瀬	カツセ	40	9769	6407689	93.632
9809	嘉戸	カド	40	9769	6407729	93.6326
9810	兼尾	カネオ	40	9769	6407769	93.6332
9811	金武	カネタケ	40	9769	6407809	93.6338
9812	蒲山	カバヤマ	40	9769	6407849	93.6344
9813	壁田	カベタ	40	9769	6407889	93.635
9814	鎌谷	カマタニ	40	9769	6407929	93.6355
9815	栢之間	カヤノマ	40	9769	6407969	93.6361
9816	栢森	カヤモリ	40	9769	6408009	93.6367
9817	川山	カワヤマ	40	9769	6408049	93.6373
9818	菊澤	キクザワ	40	9769	6408089	93.6379
9819	菊嶋	キクシマ	40	9769	6408129	93.6385
9820	喜古	キコ	40	9769	6408169	93.6391
9821	木都老	キドコロ	40	9769	6408209	93.6396
9822	木幡	キバタ	40	9769	6408249	93.6402
9823	木伏	キブシ	40	9769	6408289	93.6408
9824	清久	キヨク	40	9769	6408329	93.6414
9825	桐越	キリコシ	40	9769	6408369	93.642
9826	楠井	クスイ	40	9769	6408409	93.6426
9827	國原	クニハラ	40	9769	6408449	93.6431
9828	國安	クニヤス	40	9769	6408489	93.6437
9829	鞍田	クラタ	40	9769	6408529	93.6443
9830	倉根	クラネ	40	9769	6408569	93.6449
9831	藏本	クラモト	40	9769	6408609	93.6455
9832	栗脇	クリワキ	40	9769	6408649	93.6461
9833	高良	コウラ	40	9769	6408689	93.6467
9834	古梶	コカジ	40	9769	6408729	93.6472
9835	小佐井	コサイ	40	9769	6408769	93.6478
9836	小知和	コチワ	40	9769	6408809	93.6484
9837	小辻	コツジ	40	9769	6408849	93.649
9838	権上	ゴンジヨウ	40	9769	6408889	93.6496
9839	西海	サイカイ	40	9769	6408929	93.6502
9840	笹浪	ササナミ	40	9769	6408969	93.6507
9841	差止	サシトメ	40	9769	6409009	93.6513
9842	篠生	サソウ	40	9769	6409049	93.6519
9843	颯田	サツタ	40	9769	6409089	93.6525
9844	澤里	サワサト	40	9769	6409129	93.6531
9845	澤畑	サワハタ	40	9769	6409169	93.6537
9846	座間味	ザマミ	40	9769	6409209	93.6543
9847	塩野入	シオノイリ	40	9769	6409249	93.6548
9848	柴森	シバモリ	40	9769	6409289	93.6554
9849	島津	シマツ	40	9769	6409329	93.656
9850	庄島	シヨウジマ	40	9769	6409369	93.6566
9851	城内	シロウチ	40	9769	6409409	93.6572
9852	白勢	シロセ	40	9769	6409449	93.6578
9853	新林	シンバヤシ	40	9769	6409489	93.6583
9854	新本	シンモト	40	9769	6409529	93.6589
9855	神座	ジンザ	40	9769	6409569	93.6595
9856	菅	スゲ	40	9769	6409609	93.6601
9857	制野	セイノ	40	9769	6409649	93.6607
9858	瀬良	セラ	40	9769	6409689	93.6613
9859	曽和	ソワ	40	9769	6409729	93.6618
9860	泰楽	タイラク	40	9769	6409769	93.6624
9861	■須賀	タカスカ	40	9769	6409809	93.663
9862	高荷	タカニ	40	9769	6409849	93.6636
9863	田岸	タギシ	40	9769	6409889	93.6642
9864	武正	タケマサ	40	9769	6409929	93.6648
9865	竹屋	タケヤ	40	9769	6409969	93.6654
9866	棚井	タナイ	40	9769	6410009	93.6659
9867	種橋	タネハシ	40	9769	6410049	93.6665
9868	田幡	タバタ	40	9769	6410089	93.6671
9869	丹代	タンダイ	40	9769	6410129	93.6677
9870	大学	ダイガク	40	9769	6410169	93.6683
9871	蔦野	ツタノ	40	9769	6410209	93.6689
9872	坪江	ツボエ	40	9769	6410249	93.6694
9873	坪木	ツボキ	40	9769	6410289	93.67
9874	照内	テルウチ	40	9769	6410329	93.6706
9875	東出	トウデ	40	9769	6410369	93.6712
9876	鴇崎	トキザキ	40	9769	6410409	93.6718
9877	徳地	トクチ	40	9769	6410449	93.6724
9878	富塚	トミズカ	40	9769	6410489	93.673
9879	友清	トモキヨ	40	9769	6410529	93.6735
9880	鳥屋尾	トヤオ	40	9769	6410569	93.6741
9881	樋田	トヨダ	40	9769	6410609	93.6747
9882	中ノ瀬	ナカノセ	40	9769	6410649	93.6753
9883	中藤	ナカフジ	40	9769	6410689	93.6759
9884	中邑	ナカムラ	40	9769	6410729	93.6765
9885	中脇	ナカワキ	40	9769	6410769	93.677
9886	長松	ナガマツ	40	9769	6410809	93.6776
9887	信国	ノブクニ	40	9769	6410849	93.6782
9888	服田	ハツタ	40	9769	6410889	93.6788
9889	坂大	バンダイ	40	9769	6410929	93.6794
9890	東園	ヒガシゾノ	40	9769	6410969	93.68
9891	深海	フカウミ	40	9769	6411009	93.6806
9892	伏原	フシハラ	40	9769	6411049	93.6811
9893	藤重	フジシゲ	40	9769	6411089	93.6817
9894	蓬莱	ホウライ	40	9769	6411129	93.6823
9895	細澤	ホソザワ	40	9769	6411169	93.6829
9896	程塚	ホドヅカ	40	9769	6411209	93.6835
9897	堀下	ホリシタ	40	9769	6411249	93.6841
9898	前園	マエソノ	40	9769	6411289	93.6846
9899	柾	マサキ	40	9769	6411329	93.6852
9900	増野	マシノ	40	9769	6411369	93.6858
9901	眞島	マジマ	40	9769	6411409	93.6864
9902	松嵜	マツザキ	40	9769	6411449	93.687
9903	真々田	ママダ	40	9769	6411489	93.6876
9904	水科	ミズシナ	40	9769	6411529	93.6882
9905	水永	ミズナガ	40	9769	6411569	93.6887
9906	溝口	ミゾクチ	40	9769	6411609	93.6893
9907	光畑	ミツハタ	40	9769	6411649	93.6899
9908	簑輪	ミノワ	40	9769	6411689	93.6905
9909	麦田	ムギタ	40	9769	6411729	93.6911
9910	杢代	モクダイ	40	9769	6411769	93.6917
9911	甕	モタイ	40	9769	6411809	93.6922
9912	諸見里	モロミザト	40	9769	6411849	93.6928
9913	門真	モンマ	40	9769	6411889	93.6934
9914	八重沢	ヤエザワ	40	9769	6411929	93.694
9915	山泉	ヤマイズミ	40	9769	6411969	93.6946
9916	横島	ヨコジマ	40	9769	6412009	93.6952
9917	■富	ヨシトミ	40	9769	6412049	93.6958
9918	四辻	ヨツジ	40	9769	6412089	93.6963
9919	秋谷	アキタニ	39	9919	6412128	93.6969
9920	明野	アケノ	39	9919	6412167	93.6975
9921	阿佐	アサ	39	9919	6412206	93.698
9922	芦崎	アシザキ	39	9919	6412245	93.6986
9923	安宅	アタギ	39	9919	6412284	93.6992
9924	穴久保	アナクボ	39	9919	6412323	93.6998
9925	我孫子	アビコ	39	9919	6412362	93.7003
9926	天谷	アマガイ	39	9919	6412401	93.7009
9927	荒本	アラモト	39	9919	6412440	93.7015
9928	有友	アリトモ	39	9919	6412479	93.702
9929	家里	イエサト	39	9919	6412518	93.7026
9930	五百木	イオキ	39	9919	6412557	93.7032
9931	池宮	イケミヤ	39	9919	6412596	93.7037
9932	井指	イサシ	39	9919	6412635	93.7043
9933	伊佐山	イサヤマ	39	9919	6412674	93.7049
9934	石元	イシモト	39	9919	6412713	93.7055
9935	石割	イシワリ	39	9919	6412752	93.706
9936	板子	イタコ	39	9919	6412791	93.7066
9937	市島	イチシマ	39	9919	6412830	93.7072
9938	市ノ瀬	イチノセ	39	9919	6412869	93.7077
9939	一関	イチノセキ	39	9919	6412908	93.7083
9940	稲谷	イナタニ	39	9919	6412947	93.7089
9941	猪越	イノコシ	39	9919	6412986	93.7094
9942	猪山	イノヤマ	39	9919	6413025	93.71
9943	岩中	イワナカ	39	9919	6413064	93.7106
9944	内門	ウチカド	39	9919	6413103	93.7112
9945	内薗	ウチゾノ	39	9919	6413142	93.7117
9946	梅	ウメ	39	9919	6413181	93.7123
9947	宇留島	ウルシマ	39	9919	6413220	93.7129
9948	江面	エヅラ	39	9919	6413259	93.7134
9949	榎園	エノキゾノ	39	9919	6413298	93.714
9950	老田	オイダ	39	9919	6413337	93.7146
9951	扇原	オオギハラ	39	9919	6413376	93.7151
9952	大胡田	オオコダ	39	9919	6413415	93.7157
9953	大下	オオシモ	39	9919	6413454	93.7163
9954	大鷹	オオタカ	39	9919	6413493	93.7169
9955	大音	オオト	39	9919	6413532	93.7174
9956	大伴	オオトモ	39	9919	6413571	93.718
9957	岡倉	オカクラ	39	9919	6413610	93.7186
9958	荻堂	オギドウ	39	9919	6413649	93.7191
9959	奥嶋	オクシマ	39	9919	6413688	93.7197
9960	尾園	オゾノ	39	9919	6413727	93.7203
9961	音成	オトナリ	39	9919	6413766	93.7208
9962	及部	オヨベ	39	9919	6413805	93.7214
9963	海部	カイフ	39	9919	6413844	93.722
9964	笠貫	カサヌキ	39	9919	6413883	93.7225
9965	楫	カジ	39	9919	6413922	93.7231
9966	嘉手納	カデナ	39	9919	6413961	93.7237
9967	萱原	カヤハラ	39	9919	6414000	93.7243
9968	苅籠	カリゴメ	39	9919	6414039	93.7248
9969	神立	カンダチ	39	9919	6414078	93.7254
9970	紀伊	キイ	39	9919	6414117	93.726
9971	木岡	キオカ	39	9919	6414156	93.7265
9972	藏田	クラタ	39	9919	6414195	93.7271
9973	倉見	クラミ	39	9919	6414234	93.7277
9974	■田	クワタ	39	9919	6414273	93.7282
9975	下司	ゲシ	39	9919	6414312	93.7288
9976	鴻田	コウダ	39	9919	6414351	93.7294
9977	光野	コウノ	39	9919	6414390	93.73
9978	小窪	コクボ	39	9919	6414429	93.7305
9979	越中	コシナカ	39	9919	6414468	93.7311
9980	兒島	コジマ	39	9919	6414507	93.7317
9981	小橋川	コバシカワ	39	9919	6414546	93.7322
9982	紺屋	コンヤ	39	9919	6414585	93.7328
9983	郷家	ゴウケ	39	9919	6414624	93.7334
9984	合原	ゴウハラ	39	9919	6414663	93.7339
9985	最所	サイシヨ	39	9919	6414702	93.7345
9986	崎本	サキモト	39	9919	6414741	93.7351
9987	酒川	サケガワ	39	9919	6414780	93.7357
9988	笹平	ササヒラ	39	9919	6414819	93.7362
9989	佐島	サジマ	39	9919	6414858	93.7368
9990	重住	シゲズミ	39	9919	6414897	93.7374
9991	嶋川	シマカワ	39	9919	6414936	93.7379
9992	清水目	シミズメ	39	9919	6414975	93.7385
9993	下崎	シモザキ	39	9919	6415014	93.7391
9994	下谷	シモヤ	39	9919	6415053	93.7396
9995	社本	シヤモト	39	9919	6415092	93.7402
9996	主藤	シユドウ	39	9919	6415131	93.7408
9997	正垣	シヨウガキ	39	9919	6415170	93.7414
9998	白神	シラガ	39	9919	6415209	93.7419
9999	志良堂	シラドウ	39	9919	6415248	93.7425
10000	新舘	シンタテ	39	9919	6415287	93.7431
